word	lemma
mom	mom
senator	senator
web	web
attorney	attorney
internet	internet
baseball	baseball
basketball	basketball
creek	creek
clip	clip
teaspoon	teaspoon
tech	tech
congressman	congressman
ranch	ranch
quarterback	quarterback
makeup	makeup
lawsuit	lawsuit
jewelry	jewelry
gasoline	gasoline
teen	teen
railroad	railroad
website	website
tablespoon	tablespoon
pitcher	pitcher
freshman	freshman
backyard	backyard
sidewalk	sidewalk
announcer	announcer
prep	prep
workout	workout
skillet	skillet
playoff	playoff
taliban	taliban
rookie	rookie
mommy	mommy
hometown	hometown
touchdown	touchdown
cookie	cookie
videotape	videotape
lineup	lineup
metro	metro
aging	aging
laptop	laptop
cleanup	cleanup
elk	elk
courthouse	courthouse
sophomore	sophomore
dude	dude
pumpkin	pumpkin
flashlight	flashlight
freeway	freeway
linebacker	linebacker
blog	blog
windshield	windshield
backpack	backpack
confederate	confederate
inning	inning
lumber	lumber
juror	juror
coyote	coyote
cilantro	cilantro
asteroid	asteroid
teammate	teammate
bookstore	bookstore
headnote	headnote
sedan	sedan
strategist	strategist
curb	curb
dime	dime
pueblo	pueblo
anthrax	anthrax
salsa	salsa
interstate	interstate
bartender	bartender
mustache	mustache
baseman	baseman
shooter	shooter
softball	softball
tsunami	tsunami
hitter	hitter
rehab	rehab
roommate	roommate
bailout	bailout
breakup	breakup
twitter	twitter
momma	momma
buildup	buildup
condo	condo
filmmaker	filmmaker
paycheck	paycheck
dorm	dorm
lobbyist	lobbyist
postseason	postseason
reelection	reelection
ballpark	ballpark
foreclosure	foreclosure
offseason	offseason
sulfur	sulfur
tofu	tofu
preseason	preseason
congresswoman	congresswoman
nighttime	nighttime
pitching	pitching
zucchini	zucchini
backcountry	backcountry
bathtub	bathtub
eggplant	eggplant
abs	abs
browser	browser
firefighter	firefighter
chile	chile
recount	recount
intern	intern
staffer	staffer
cornerback	cornerback
backseat	backseat
euro	euro
bullpen	bullpen
buttermilk	buttermilk
cellphone	cellphone
shortstop	shortstop
standoff	standoff
ipod	ipod
sushi	sushi
homeowner	homeowner
cyberspace	cyberspace
aspen	aspen
makeover	makeover
outfielder	outfielder
halftime	halftime
drugstore	drugstore
frosting	frosting
classmate	classmate
homer	homer
resume	resume
ax	ax
diaper	diaper
counterterrorism	counterterrorism
app	app
iphone	iphone
pecan	pecan
watermelon	watermelon
gridlock	gridlock
timeline	timeline
grad	grad
minivan	minivan
roundtable	roundtable
lefty	lefty
matchup	matchup
winery	winery
tarp	tarp
lineman	lineman
cornmeal	cornmeal
fastball	fastball
swath	swath
takeoff	takeoff
midterm	midterm
faucet	faucet
pollster	pollster
coauthor	coauthor
beltway	beltway
sync	sync
lacrosse	lacrosse
cornstarch	cornstarch
bayou	bayou
missy	missy
fundraiser	fundraiser
kickoff	kickoff
sled	sled
reliever	reliever
storefront	storefront
bluegrass	bluegrass
dermatologist	dermatologist
tenderloin	tenderloin
rooster	rooster
levee	levee
brunch	brunch
fest	fest
expletive	expletive
cheerleader	cheerleader
condominium	condominium
dumpster	dumpster
dispatcher	dispatcher
rancher	rancher
desegregation	desegregation
meth	meth
trailhead	trailhead
veterinarian	veterinarian
automaker	automaker
stroller	stroller
infield	infield
showtime	showtime
entree	entree
campground	campground
telecom	telecom
newscast	newscast
filibuster	filibuster
standout	standout
blueberry	blueberry
daycare	daycare
blowout	blowout
feta	feta
restroom	restroom
canola	canola
undersecretary	undersecretary
swat	swat
corral	corral
mitt	mitt
normalcy	normalcy
pocketbook	pocketbook
polenta	polenta
retiree	retiree
soundbite	soundbite
bagel	bagel
workday	workday
nightstand	nightstand
payday	payday
broiler	broiler
walleye	walleye
cofounder	cofounder
kilometer	kilometer
lawmaker	lawmaker
capitol	capitol
download	download
mammogram	mammogram
sex/nudity	sex/nudity
arugula	arugula
lockout	lockout
butte	butte
sailboat	sailboat
gurney	gurney
veggie	veggie
raccoon	raccoon
semifinal	semifinal
brisket	brisket
shootout	shootout
mountaintop	mountaintop
liter	liter
geek	geek
furor	furor
puck	puck
derailleur	derailleur
lasagna	lasagna
dumbbell	dumbbell
blogger	blogger
steelhead	steelhead
dunk	dunk
firestorm	firestorm
chemo	chemo
countertop	countertop
millimeter	millimeter
jalapeno	jalapeno
scrimmage	scrimmage
sat	sat
realtor	realtor
barbershop	barbershop
mesa	mesa
coworker	coworker
airfare	airfare
entryway	entryway
redistricting	redistricting
tailback	tailback
bipartisanship	bipartisanship
whiz	whiz
pita	pita
checkup	checkup
rusher	rusher
boomer	boomer
apnea	apnea
hardball	hardball
avatar	avatar
whitetail	whitetail
mailman	mailman
broadband	broadband
sorority	sorority
bighorn	bighorn
grizzly	grizzly
omelet	omelet
cornbread	cornbread
takeout	takeout
motherfucker	motherfucker
snowboarding	snowboarding
mormon	mormon
pullout	pullout
layoff	layoff
slugger	slugger
sagebrush	sagebrush
mammography	mammography
bio	bio
hangout	hangout
cougar	cougar
gobbler	gobbler
cheerleading	cheerleading
chipotle	chipotle
burlap	burlap
midsection	midsection
latte	latte
largemouth	largemouth
defenseman	defenseman
cossack	cossack
sneaker	sneaker
streetcar	streetcar
panhandle	panhandle
playbook	playbook
snowmobile	snowmobile
drivetrain	drivetrain
texting	texting
snowboard	snowboard
blacktop	blacktop
mesquite	mesquite
heft	heft
malware	malware
councilman	councilman
facedown	facedown
ruble	ruble
clothesline	clothesline
oncologist	oncologist
frat	frat
eatery	eatery
beeper	beeper
costar	costar
granola	granola
riverboat	riverboat
licorice	licorice
firewall	firewall
shutout	shutout
recliner	recliner
cantaloupe	cantaloupe
cobblestone	cobblestone
washcloth	washcloth
crawfish	crawfish
butternut	butternut
drywall	drywall
ahold	ahold
steakhouse	steakhouse
grammy	grammy
cottonwood	cottonwood
internist	internist
chowder	chowder
margarita	margarita
slaw	slaw
romaine	romaine
timeout	timeout
spinoff	spinoff
sellout	sellout
caseworker	caseworker
tarpon	tarpon
filet	filet
applesauce	applesauce
gator	gator
ballgame	ballgame
seafloor	seafloor
superhighway	superhighway
midmorning	midmorning
sandbox	sandbox
leadoff	leadoff
laundromat	laundromat
firefight	firefight
nonviolence	nonviolence
midafternoon	midafternoon
oxymoron	oxymoron
newsstand	newsstand
tux	tux
kudzu	kudzu
bandanna	bandanna
firehouse	firehouse
statehouse	statehouse
potluck	potluck
ecotourism	ecotourism
lakefront	lakefront
donut	donut
windbreaker	windbreaker
cutthroat	cutthroat
burrito	burrito
smallmouth	smallmouth
volunteerism	volunteerism
shiite	shiite
spyware	spyware
vise	vise
saltwater	saltwater
hodgepodge	hodgepodge
liposuction	liposuction
antioxidant	antioxidant
telecommuting	telecommuting
guacamole	guacamole
ballplayer	ballplayer
flaxseed	flaxseed
spandex	spandex
hummer	hummer
newsmaker	newsmaker
backfield	backfield
arraignment	arraignment
multimillionaire	multimillionaire
meatloaf	meatloaf
backcourt	backcourt
anesthesiologist	anesthesiologist
jackass	jackass
layup	layup
phyllo	phyllo
overpass	overpass
wastebasket	wastebasket
letdown	letdown
infielder	infielder
pepperoni	pepperoni
laypeople	laypeople
sportswriter	sportswriter
ibuprofen	ibuprofen
sportscaster	sportscaster
quinoa	quinoa
crappie	crappie
preschooler	preschooler
seatpost	seatpost
misstep	misstep
hookup	hookup
coffeehouse	coffeehouse
panty	panty
ironclad	ironclad
sourdough	sourdough
granddaddy	granddaddy
gangsta	gangsta
telecast	telecast
cabinetry	cabinetry
holdout	holdout
lunchroom	lunchroom
liftoff	liftoff
acetaminophen	acetaminophen
sledding	sledding
cupcake	cupcake
appraiser	appraiser
critter	critter
pantyhose	pantyhose
frontrunner	frontrunner
petri	petri
stinger	stinger
lockdown	lockdown
parkway	parkway
skyrocket	skyrocket
pancetta	pancetta
tryout	tryout
niacin	niacin
armoire	armoire
curveball	curveball
wormhole	wormhole
smartphone	smartphone
taser	taser
collard	collard
palmetto	palmetto
rowboat	rowboat
pretzel	pretzel
valedictorian	valedictorian
shtick	shtick
focuser	focuser
marinara	marinara
jetliner	jetliner
decaf	decaf
pronghorn	pronghorn
ridership	ridership
goldenrod	goldenrod
bulgur	bulgur
midcentury	midcentury
phenom	phenom
barroom	barroom
workweek	workweek
flatware	flatware
neuroscientist	neuroscientist
weeknight	weeknight
councilwoman	councilwoman
menorah	menorah
homeownership	homeownership
goaltender	goaltender
doneness	doneness
bobcat	bobcat
rollback	rollback
postgame	postgame
pantsuit	pantsuit
lycopene	lycopene
eurozone	eurozone
wideout	wideout
viewership	viewership
spaceflight	spaceflight
happenstance	happenstance
outcropping	outcropping
stoplight	stoplight
deadbeat	deadbeat
backhoe	backhoe
calamari	calamari
ethicist	ethicist
luge	luge
student/teacher	student/teacher
rollout	rollout
boxcar	boxcar
ponderosa	ponderosa
reb	reb
leaguer	leaguer
antiaircraft	antiaircraft
backboard	backboard
manatee	manatee
ginkgo	ginkgo
cheater	cheater
emcee	emcee
woodstove	woodstove
cuban	cuban
tendinitis	tendinitis
newlywed	newlywed
waterboarding	waterboarding
grownup	grownup
rebounder	rebounder
baitfish	baitfish
demagoguery	demagoguery
riverfront	riverfront
amygdala	amygdala
homocysteine	homocysteine
bellwether	bellwether
seder	seder
noontime	noontime
headliner	headliner
warmup	warmup
lakeshore	lakeshore
birding	birding
masa	masa
beachhead	beachhead
redshirt	redshirt
portobello	portobello
singletrack	singletrack
hairstylist	hairstylist
rotator	rotator
redfish	redfish
scallion	scallion
lemongrass	lemongrass
wasabi	wasabi
echinacea	echinacea
nigga	nigga
lube	lube
homeroom	homeroom
worktable	worktable
seawall	seawall
muskie	muskie
berm	berm
racquetball	racquetball
voicemail	voicemail
URL	url
silicosis	silicosis
grinch	grinch
whitefish	whitefish
snicker	snicker
orzo	orzo
firecracker	firecracker
newsmagazine	newsmagazine
eggnog	eggnog
webcam	webcam
busboy	busboy
carburetor	carburetor
marist	marist
agave	agave
tepee	tepee
coverup	coverup
crabmeat	crabmeat
shiitake	shiitake
dollhouse	dollhouse
ragtag	ragtag
inbox	inbox
standup	standup
wiretapping	wiretapping
merlot	merlot
blogosphere	blogosphere
doubleheader	doubleheader
oceanfront	oceanfront
adobo	adobo
archeologist	archeologist
lockup	lockup
masonite	masonite
tailpipe	tailpipe
fistfight	fistfight
popsicle	popsicle
rotisserie	rotisserie
copilot	copilot
earmark	earmark
statin	statin
skeet	skeet
whir	whir
grounder	grounder
dinette	dinette
snowshoe	snowshoe
shakeup	shakeup
pullback	pullback
mascarpone	mascarpone
treehouse	treehouse
bologna	bologna
renter	renter
maven	maven
heartthrob	heartthrob
deejay	deejay
mormonism	mormonism
fishbowl	fishbowl
lutein	lutein
outdoorsman	outdoorsman
sunroom	sunroom
saguaro	saguaro
pilothouse	pilothouse
tidbit	tidbit
strep	strep
thievery	thievery
pocketknife	pocketknife
stovetop	stovetop
lockstep	lockstep
ridgeline	ridgeline
linguine	linguine
iceman	iceman
chaparral	chaparral
housecleaning	housecleaning
bachelorette	bachelorette
guardrail	guardrail
speakerphone	speakerphone
ocher	ocher
boardinghouse	boardinghouse
snowpack	snowpack
flyby	flyby
cabdriver	cabdriver
sleepover	sleepover
rolodex	rolodex
coffeemaker	coffeemaker
ballclub	ballclub
snitch	snitch
focaccia	focaccia
caulk	caulk
holdup	holdup
blowup	blowup
telomerase	telomerase
sharecropper	sharecropper
wiretap	wiretap
macadamia	macadamia
largess	largess
groundhog	groundhog
soymilk	soymilk
nanosecond	nanosecond
jicama	jicama
cinderblock	cinderblock
crankset	crankset
staph	staph
gelato	gelato
sockeye	sockeye
gonzo	gonzo
faceup	faceup
remodel	remodel
gulch	gulch
anasazi	anasazi
powertrain	powertrain
piecrust	piecrust
reticle	reticle
linguini	linguini
cookout	cookout
seltzer	seltzer
fettuccine	fettuccine
escarole	escarole
knockoff	knockoff
dork	dork
windup	windup
antiterrorism	antiterrorism
watercraft	watercraft
videogame	videogame
telemark	telemark
nutria	nutria
meatball	meatball
airstrike	airstrike
snowboarder	snowboarder
mockingbird	mockingbird
aftershock	aftershock
profiler	profiler
perp	perp
graywater	graywater
segue	segue
backstop	backstop
coffeepot	coffeepot
righthander	righthander
jackhammer	jackhammer
bunt	bunt
porcini	porcini
overabundance	overabundance
crosswalk	crosswalk
screener	screener
bruschetta	bruschetta
saucepot	saucepot
bling	bling
bronzer	bronzer
bowhunting	bowhunting
honoree	honoree
sumac	sumac
sunup	sunup
wakeup	wakeup
strikeout	strikeout
baggie	baggie
mailroom	mailroom
yarmulke	yarmulke
gravesite	gravesite
backsplash	backsplash
telemarketer	telemarketer
astrophotography	astrophotography
ephedra	ephedra
layover	layover
buyback	buyback
progestin	progestin
enchilada	enchilada
stagehand	stagehand
striper	striper
dinnerware	dinnerware
hoodie	hoodie
reapportionment	reapportionment
springform	springform
varmint	varmint
polygamist	polygamist
stepmom	stepmom
codirector	codirector
undergrad	undergrad
handoff	handoff
decal	decal
flatiron	flatiron
wonk	wonk
basketry	basketry
sashimi	sashimi
lodgepole	lodgepole
recon	recon
grousing	grousing
sidearm	sidearm
trailblazer	trailblazer
landscaper	landscaper
subcompact	subcompact
tahini	tahini
gamer	gamer
energizer	energizer
flatbread	flatbread
stakeout	stakeout
kiva	kiva
getup	getup
fieldstone	fieldstone
foxhole	foxhole
centerline	centerline
hominy	hominy
rainmaker	rainmaker
compactor	compactor
speedskating	speedskating
bluegill	bluegill
intranet	intranet
moviemaking	moviemaking
tidewater	tidewater
lupine	lupine
carpool	carpool
taskbar	taskbar
laughingstock	laughingstock
backstory	backstory
gamefish	gamefish
flyfishing	flyfishing
pushup	pushup
cookstove	cookstove
bratwurst	bratwurst
teamster	teamster
frittata	frittata
wildland	wildland
minicamp	minicamp
ultralight	ultralight
tamale	tamale
steerer	steerer
docent	docent
leptin	leptin
moneymaker	moneymaker
cantina	cantina
resveratrol	resveratrol
sass	sass
tailbone	tailbone
downstate	downstate
sidecut	sidecut
stomachache	stomachache
groundskeeper	groundskeeper
gainer	gainer
lumberyard	lumberyard
podiatrist	podiatrist
lawman	lawman
overlook	overlook
snowmobiling	snowmobiling
muzzleloader	muzzleloader
teakettle	teakettle
orthodontist	orthodontist
frontcourt	frontcourt
penlight	penlight
handspring	handspring
attendee	attendee
oversupply	oversupply
megachurch	megachurch
passel	passel
barrette	barrette
changeup	changeup
tiramisu	tiramisu
cooktop	cooktop
gluteus	gluteus
fraktur	fraktur
snafu	snafu
techie	techie
kickball	kickball
lox	lox
bassinet	bassinet
daikon	daikon
nanotube	nanotube
slickrock	slickrock
falafel	falafel
caboose	caboose
boondoggle	boondoggle
swingman	swingman
provolone	provolone
photosphere	photosphere
stoner	stoner
rezoning	rezoning
stingray	stingray
zookeeper	zookeeper
credenza	credenza
gorgonzola	gorgonzola
hottie	hottie
peeve	peeve
narcissist	narcissist
cybersecurity	cybersecurity
catchall	catchall
mudroom	mudroom
orthopedist	orthopedist
bundt	bundt
spiderweb	spiderweb
videographer	videographer
homeschooling	homeschooling
pitchman	pitchman
preproduction	preproduction
birdhouse	birdhouse
bobber	bobber
newbie	newbie
bleacher	bleacher
burg	burg
ceramist	ceramist
sanitarium	sanitarium
halfpipe	halfpipe
cellblock	cellblock
boomtown	boomtown
snowbank	snowbank
roadbed	roadbed
chainring	chainring
doozy	doozy
preteen	preteen
pushback	pushback
morph	morph
beanie	beanie
racecar	racecar
cannoli	cannoli
strider	strider
ridgetop	ridgetop
soundstage	soundstage
jambalaya	jambalaya
watercooler	watercooler
ancho	ancho
preventer	preventer
infotech	infotech
clunker	clunker
cosmetology	cosmetology
trifecta	trifecta
pinup	pinup
feedlot	feedlot
stepparent	stepparent
superstardom	superstardom
gantlet	gantlet
timberland	timberland
likability	likability
temblor	temblor
multiverse	multiverse
colic	colic
garbanzo	garbanzo
dodgeball	dodgeball
telepresence	telepresence
bonobo	bonobo
pinwheel	pinwheel
housedress	housedress
sheetrock	sheetrock
teepee	teepee
soba	soba
collimation	collimation
kook	kook
veep	veep
carpaccio	carpaccio
shortcake	shortcake
anticorruption	anticorruption
tallgrass	tallgrass
hardtail	hardtail
packbag	packbag
puter	puter
aerie	aerie
updraft	updraft
brights	brights
deliveryman	deliveryman
semifinalist	semifinalist
skybox	skybox
shirtwaist	shirtwaist
homestand	homestand
moviegoer	moviegoer
daypack	daypack
goop	goop
rigatoni	rigatoni
criminalist	criminalist
freeride	freeride
starcraft	starcraft
houseguest	houseguest
timberline	timberline
sandhill	sandhill
overachiever	overachiever
roaster	roaster
anime	anime
tapenade	tapenade
bottler	bottler
gobble	gobble
tyrannosaur	tyrannosaur
crapshoot	crapshoot
spritz	spritz
pinata	pinata
mesclun	mesclun
toque	toque
hayride	hayride
showstopper	showstopper
windstorm	windstorm
gazillion	gazillion
jackknife	jackknife
dotcom	dotcom
nametag	nametag
hymnal	hymnal
estrus	estrus
goofball	goofball
highball	highball
wallboard	wallboard
nitroglycerin	nitroglycerin
uplink	uplink
upload	upload
patroller	patroller
oxycodone	oxycodone
grandstanding	grandstanding
roadkill	roadkill
anchorwoman	anchorwoman
takedown	takedown
challah	challah
barkeep	barkeep
spacewalk	spacewalk
hypoglycemia	hypoglycemia
terrarium	terrarium
topwater	topwater
bowhunter	bowhunter
schooler	schooler
raingear	raingear
snowsuit	snowsuit
gyno	gyno
zine	zine
rainfly	rainfly
subspace	subspace
andro	andro
thimerosal	thimerosal
castoff	castoff
falloff	falloff
pinon	pinon
fontina	fontina
panfish	panfish
tippet	tippet
crankbait	crankbait
eland	eland
quarterbacking	quarterbacking
whiner	whiner
lockbox	lockbox
inclusivity	inclusivity
aircar	aircar
archrival	archrival
fingerling	fingerling
sidewinder	sidewinder
subwoofer	subwoofer
exerciser	exerciser
buckboard	buckboard
neediness	neediness
mensch	mensch
tomatillo	tomatillo
teleportation	teleportation
pumper	pumper
lightsaber	lightsaber
rinderpest	rinderpest
shuffleboard	shuffleboard
nonpartisan	nonpartisan
roundtrip	roundtrip
feces	feces
tike	tike
biohazard	biohazard
touchpad	touchpad
airboat	airboat
coeditor	coeditor
uniter	uniter
stickball	stickball
deadfall	deadfall
backstretch	backstretch
mirin	mirin
rutabaga	rutabaga
tricorder	tricorder
savor	savor
tuneup	tuneup
assemblywoman	assemblywoman
tempura	tempura
showboat	showboat
word	lemma
mom	mom
senator	senator
web	web
attorney	attorney
internet	internet
baseball	baseball
basketball	basketball
creek	creek
clip	clip
teaspoon	teaspoon
tech	tech
congressman	congressman
ranch	ranch
quarterback	quarterback
makeup	makeup
lawsuit	lawsuit
jewelry	jewelry
gasoline	gasoline
teen	teen
railroad	railroad
website	website
tablespoon	tablespoon
pitcher	pitcher
freshman	freshman
backyard	backyard
sidewalk	sidewalk
announcer	announcer
prep	prep
workout	workout
skillet	skillet
playoff	playoff
taliban	taliban
rookie	rookie
mommy	mommy
hometown	hometown
touchdown	touchdown
cookie	cookie
videotape	videotape
lineup	lineup
metro	metro
aging	aging
laptop	laptop
cleanup	cleanup
elk	elk
courthouse	courthouse
sophomore	sophomore
dude	dude
pumpkin	pumpkin
flashlight	flashlight
freeway	freeway
linebacker	linebacker
blog	blog
windshield	windshield
backpack	backpack
confederate	confederate
inning	inning
lumber	lumber
juror	juror
coyote	coyote
cilantro	cilantro
asteroid	asteroid
teammate	teammate
bookstore	bookstore
headnote	headnote
sedan	sedan
strategist	strategist
curb	curb
dime	dime
pueblo	pueblo
anthrax	anthrax
salsa	salsa
interstate	interstate
bartender	bartender
mustache	mustache
baseman	baseman
shooter	shooter
softball	softball
tsunami	tsunami
hitter	hitter
rehab	rehab
roommate	roommate
bailout	bailout
breakup	breakup
twitter	twitter
momma	momma
buildup	buildup
condo	condo
filmmaker	filmmaker
paycheck	paycheck
dorm	dorm
lobbyist	lobbyist
postseason	postseason
reelection	reelection
ballpark	ballpark
foreclosure	foreclosure
offseason	offseason
sulfur	sulfur
tofu	tofu
preseason	preseason
congresswoman	congresswoman
nighttime	nighttime
pitching	pitching
zucchini	zucchini
backcountry	backcountry
bathtub	bathtub
eggplant	eggplant
abs	abs
browser	browser
firefighter	firefighter
chile	chile
recount	recount
intern	intern
staffer	staffer
cornerback	cornerback
backseat	backseat
euro	euro
bullpen	bullpen
buttermilk	buttermilk
cellphone	cellphone
shortstop	shortstop
standoff	standoff
ipod	ipod
sushi	sushi
homeowner	homeowner
cyberspace	cyberspace
aspen	aspen
makeover	makeover
outfielder	outfielder
halftime	halftime
drugstore	drugstore
frosting	frosting
classmate	classmate
homer	homer
resume	resume
ax	ax
diaper	diaper
counterterrorism	counterterrorism
app	app
iphone	iphone
pecan	pecan
watermelon	watermelon
gridlock	gridlock
timeline	timeline
grad	grad
minivan	minivan
roundtable	roundtable
lefty	lefty
matchup	matchup
winery	winery
tarp	tarp
lineman	lineman
cornmeal	cornmeal
fastball	fastball
swath	swath
takeoff	takeoff
midterm	midterm
faucet	faucet
pollster	pollster
coauthor	coauthor
beltway	beltway
sync	sync
lacrosse	lacrosse
cornstarch	cornstarch
bayou	bayou
missy	missy
fundraiser	fundraiser
kickoff	kickoff
sled	sled
reliever	reliever
storefront	storefront
bluegrass	bluegrass
dermatologist	dermatologist
tenderloin	tenderloin
rooster	rooster
levee	levee
brunch	brunch
fest	fest
expletive	expletive
cheerleader	cheerleader
condominium	condominium
dumpster	dumpster
dispatcher	dispatcher
rancher	rancher
desegregation	desegregation
meth	meth
trailhead	trailhead
veterinarian	veterinarian
automaker	automaker
stroller	stroller
infield	infield
showtime	showtime
entree	entree
campground	campground
telecom	telecom
newscast	newscast
filibuster	filibuster
standout	standout
blueberry	blueberry
daycare	daycare
blowout	blowout
feta	feta
restroom	restroom
canola	canola
undersecretary	undersecretary
swat	swat
corral	corral
mitt	mitt
normalcy	normalcy
pocketbook	pocketbook
polenta	polenta
retiree	retiree
soundbite	soundbite
bagel	bagel
workday	workday
nightstand	nightstand
payday	payday
broiler	broiler
walleye	walleye
cofounder	cofounder
kilometer	kilometer
lawmaker	lawmaker
capitol	capitol
download	download
mammogram	mammogram
sex/nudity	sex/nudity
arugula	arugula
lockout	lockout
butte	butte
sailboat	sailboat
gurney	gurney
veggie	veggie
raccoon	raccoon
semifinal	semifinal
brisket	brisket
shootout	shootout
mountaintop	mountaintop
liter	liter
geek	geek
furor	furor
puck	puck
derailleur	derailleur
lasagna	lasagna
dumbbell	dumbbell
blogger	blogger
steelhead	steelhead
dunk	dunk
firestorm	firestorm
chemo	chemo
countertop	countertop
millimeter	millimeter
jalapeno	jalapeno
scrimmage	scrimmage
sat	sat
realtor	realtor
barbershop	barbershop
mesa	mesa
coworker	coworker
airfare	airfare
entryway	entryway
redistricting	redistricting
tailback	tailback
bipartisanship	bipartisanship
whiz	whiz
pita	pita
checkup	checkup
rusher	rusher
boomer	boomer
apnea	apnea
hardball	hardball
avatar	avatar
whitetail	whitetail
mailman	mailman
broadband	broadband
sorority	sorority
bighorn	bighorn
grizzly	grizzly
omelet	omelet
cornbread	cornbread
takeout	takeout
motherfucker	motherfucker
snowboarding	snowboarding
mormon	mormon
pullout	pullout
layoff	layoff
slugger	slugger
sagebrush	sagebrush
mammography	mammography
bio	bio
hangout	hangout
cougar	cougar
gobbler	gobbler
cheerleading	cheerleading
chipotle	chipotle
burlap	burlap
midsection	midsection
latte	latte
largemouth	largemouth
defenseman	defenseman
cossack	cossack
sneaker	sneaker
streetcar	streetcar
panhandle	panhandle
playbook	playbook
snowmobile	snowmobile
drivetrain	drivetrain
texting	texting
snowboard	snowboard
blacktop	blacktop
mesquite	mesquite
heft	heft
malware	malware
councilman	councilman
facedown	facedown
ruble	ruble
clothesline	clothesline
oncologist	oncologist
frat	frat
eatery	eatery
beeper	beeper
costar	costar
granola	granola
riverboat	riverboat
licorice	licorice
firewall	firewall
shutout	shutout
recliner	recliner
cantaloupe	cantaloupe
cobblestone	cobblestone
washcloth	washcloth
crawfish	crawfish
butternut	butternut
drywall	drywall
ahold	ahold
steakhouse	steakhouse
grammy	grammy
cottonwood	cottonwood
internist	internist
chowder	chowder
margarita	margarita
slaw	slaw
romaine	romaine
timeout	timeout
spinoff	spinoff
sellout	sellout
caseworker	caseworker
tarpon	tarpon
filet	filet
applesauce	applesauce
gator	gator
ballgame	ballgame
seafloor	seafloor
superhighway	superhighway
midmorning	midmorning
sandbox	sandbox
leadoff	leadoff
laundromat	laundromat
firefight	firefight
nonviolence	nonviolence
midafternoon	midafternoon
oxymoron	oxymoron
newsstand	newsstand
tux	tux
kudzu	kudzu
bandanna	bandanna
firehouse	firehouse
statehouse	statehouse
potluck	potluck
ecotourism	ecotourism
lakefront	lakefront
donut	donut
windbreaker	windbreaker
cutthroat	cutthroat
burrito	burrito
smallmouth	smallmouth
volunteerism	volunteerism
shiite	shiite
spyware	spyware
vise	vise
saltwater	saltwater
hodgepodge	hodgepodge
liposuction	liposuction
antioxidant	antioxidant
telecommuting	telecommuting
guacamole	guacamole
ballplayer	ballplayer
flaxseed	flaxseed
spandex	spandex
hummer	hummer
newsmaker	newsmaker
backfield	backfield
arraignment	arraignment
multimillionaire	multimillionaire
meatloaf	meatloaf
backcourt	backcourt
anesthesiologist	anesthesiologist
jackass	jackass
layup	layup
phyllo	phyllo
overpass	overpass
wastebasket	wastebasket
letdown	letdown
infielder	infielder
pepperoni	pepperoni
laypeople	laypeople
sportswriter	sportswriter
ibuprofen	ibuprofen
sportscaster	sportscaster
quinoa	quinoa
crappie	crappie
preschooler	preschooler
seatpost	seatpost
misstep	misstep
hookup	hookup
coffeehouse	coffeehouse
panty	panty
ironclad	ironclad
sourdough	sourdough
granddaddy	granddaddy
gangsta	gangsta
telecast	telecast
cabinetry	cabinetry
holdout	holdout
lunchroom	lunchroom
liftoff	liftoff
acetaminophen	acetaminophen
sledding	sledding
cupcake	cupcake
appraiser	appraiser
critter	critter
pantyhose	pantyhose
frontrunner	frontrunner
petri	petri
stinger	stinger
lockdown	lockdown
parkway	parkway
skyrocket	skyrocket
pancetta	pancetta
tryout	tryout
niacin	niacin
armoire	armoire
curveball	curveball
wormhole	wormhole
smartphone	smartphone
taser	taser
collard	collard
palmetto	palmetto
rowboat	rowboat
pretzel	pretzel
valedictorian	valedictorian
shtick	shtick
focuser	focuser
marinara	marinara
jetliner	jetliner
decaf	decaf
pronghorn	pronghorn
ridership	ridership
goldenrod	goldenrod
bulgur	bulgur
midcentury	midcentury
phenom	phenom
barroom	barroom
workweek	workweek
flatware	flatware
neuroscientist	neuroscientist
weeknight	weeknight
councilwoman	councilwoman
menorah	menorah
homeownership	homeownership
goaltender	goaltender
doneness	doneness
bobcat	bobcat
rollback	rollback
postgame	postgame
pantsuit	pantsuit
lycopene	lycopene
eurozone	eurozone
wideout	wideout
viewership	viewership
spaceflight	spaceflight
happenstance	happenstance
outcropping	outcropping
stoplight	stoplight
deadbeat	deadbeat
backhoe	backhoe
calamari	calamari
ethicist	ethicist
luge	luge
student/teacher	student/teacher
rollout	rollout
boxcar	boxcar
ponderosa	ponderosa
reb	reb
leaguer	leaguer
antiaircraft	antiaircraft
backboard	backboard
manatee	manatee
ginkgo	ginkgo
cheater	cheater
emcee	emcee
woodstove	woodstove
cuban	cuban
tendinitis	tendinitis
newlywed	newlywed
waterboarding	waterboarding
grownup	grownup
rebounder	rebounder
baitfish	baitfish
demagoguery	demagoguery
riverfront	riverfront
amygdala	amygdala
homocysteine	homocysteine
bellwether	bellwether
seder	seder
noontime	noontime
headliner	headliner
warmup	warmup
lakeshore	lakeshore
birding	birding
masa	masa
beachhead	beachhead
redshirt	redshirt
portobello	portobello
singletrack	singletrack
hairstylist	hairstylist
rotator	rotator
redfish	redfish
scallion	scallion
lemongrass	lemongrass
wasabi	wasabi
echinacea	echinacea
nigga	nigga
lube	lube
homeroom	homeroom
worktable	worktable
seawall	seawall
muskie	muskie
berm	berm
racquetball	racquetball
voicemail	voicemail
URL	url
silicosis	silicosis
grinch	grinch
whitefish	whitefish
snicker	snicker
orzo	orzo
firecracker	firecracker
newsmagazine	newsmagazine
eggnog	eggnog
webcam	webcam
busboy	busboy
carburetor	carburetor
marist	marist
agave	agave
tepee	tepee
coverup	coverup
crabmeat	crabmeat
shiitake	shiitake
dollhouse	dollhouse
ragtag	ragtag
inbox	inbox
standup	standup
wiretapping	wiretapping
merlot	merlot
blogosphere	blogosphere
doubleheader	doubleheader
oceanfront	oceanfront
adobo	adobo
archeologist	archeologist
lockup	lockup
masonite	masonite
tailpipe	tailpipe
fistfight	fistfight
popsicle	popsicle
rotisserie	rotisserie
copilot	copilot
earmark	earmark
statin	statin
skeet	skeet
whir	whir
grounder	grounder
dinette	dinette
snowshoe	snowshoe
shakeup	shakeup
pullback	pullback
mascarpone	mascarpone
treehouse	treehouse
bologna	bologna
renter	renter
maven	maven
heartthrob	heartthrob
deejay	deejay
mormonism	mormonism
fishbowl	fishbowl
lutein	lutein
outdoorsman	outdoorsman
sunroom	sunroom
saguaro	saguaro
pilothouse	pilothouse
tidbit	tidbit
strep	strep
thievery	thievery
pocketknife	pocketknife
stovetop	stovetop
lockstep	lockstep
ridgeline	ridgeline
linguine	linguine
iceman	iceman
chaparral	chaparral
housecleaning	housecleaning
bachelorette	bachelorette
guardrail	guardrail
speakerphone	speakerphone
ocher	ocher
boardinghouse	boardinghouse
snowpack	snowpack
flyby	flyby
cabdriver	cabdriver
sleepover	sleepover
rolodex	rolodex
coffeemaker	coffeemaker
ballclub	ballclub
snitch	snitch
focaccia	focaccia
caulk	caulk
holdup	holdup
blowup	blowup
telomerase	telomerase
sharecropper	sharecropper
wiretap	wiretap
macadamia	macadamia
largess	largess
groundhog	groundhog
soymilk	soymilk
nanosecond	nanosecond
jicama	jicama
cinderblock	cinderblock
crankset	crankset
staph	staph
gelato	gelato
sockeye	sockeye
gonzo	gonzo
faceup	faceup
remodel	remodel
gulch	gulch
anasazi	anasazi
powertrain	powertrain
piecrust	piecrust
reticle	reticle
linguini	linguini
cookout	cookout
seltzer	seltzer
fettuccine	fettuccine
escarole	escarole
knockoff	knockoff
dork	dork
windup	windup
antiterrorism	antiterrorism
watercraft	watercraft
videogame	videogame
telemark	telemark
nutria	nutria
meatball	meatball
airstrike	airstrike
snowboarder	snowboarder
mockingbird	mockingbird
aftershock	aftershock
profiler	profiler
perp	perp
graywater	graywater
segue	segue
backstop	backstop
coffeepot	coffeepot
righthander	righthander
jackhammer	jackhammer
bunt	bunt
porcini	porcini
overabundance	overabundance
crosswalk	crosswalk
screener	screener
bruschetta	bruschetta
saucepot	saucepot
bling	bling
bronzer	bronzer
bowhunting	bowhunting
honoree	honoree
sumac	sumac
sunup	sunup
wakeup	wakeup
strikeout	strikeout
baggie	baggie
mailroom	mailroom
yarmulke	yarmulke
gravesite	gravesite
backsplash	backsplash
telemarketer	telemarketer
astrophotography	astrophotography
ephedra	ephedra
layover	layover
buyback	buyback
progestin	progestin
enchilada	enchilada
stagehand	stagehand
striper	striper
dinnerware	dinnerware
hoodie	hoodie
reapportionment	reapportionment
springform	springform
varmint	varmint
polygamist	polygamist
stepmom	stepmom
codirector	codirector
undergrad	undergrad
handoff	handoff
decal	decal
flatiron	flatiron
wonk	wonk
basketry	basketry
sashimi	sashimi
lodgepole	lodgepole
recon	recon
grousing	grousing
sidearm	sidearm
trailblazer	trailblazer
landscaper	landscaper
subcompact	subcompact
tahini	tahini
gamer	gamer
energizer	energizer
flatbread	flatbread
stakeout	stakeout
kiva	kiva
getup	getup
fieldstone	fieldstone
foxhole	foxhole
centerline	centerline
hominy	hominy
rainmaker	rainmaker
compactor	compactor
speedskating	speedskating
bluegill	bluegill
intranet	intranet
moviemaking	moviemaking
tidewater	tidewater
lupine	lupine
carpool	carpool
taskbar	taskbar
laughingstock	laughingstock
backstory	backstory
gamefish	gamefish
flyfishing	flyfishing
pushup	pushup
cookstove	cookstove
bratwurst	bratwurst
teamster	teamster
frittata	frittata
wildland	wildland
minicamp	minicamp
ultralight	ultralight
tamale	tamale
steerer	steerer
docent	docent
leptin	leptin
moneymaker	moneymaker
cantina	cantina
resveratrol	resveratrol
sass	sass
tailbone	tailbone
downstate	downstate
sidecut	sidecut
stomachache	stomachache
groundskeeper	groundskeeper
gainer	gainer
lumberyard	lumberyard
podiatrist	podiatrist
lawman	lawman
overlook	overlook
snowmobiling	snowmobiling
muzzleloader	muzzleloader
teakettle	teakettle
orthodontist	orthodontist
frontcourt	frontcourt
penlight	penlight
handspring	handspring
attendee	attendee
oversupply	oversupply
megachurch	megachurch
passel	passel
barrette	barrette
changeup	changeup
tiramisu	tiramisu
cooktop	cooktop
gluteus	gluteus
fraktur	fraktur
snafu	snafu
techie	techie
kickball	kickball
lox	lox
bassinet	bassinet
daikon	daikon
nanotube	nanotube
slickrock	slickrock
falafel	falafel
caboose	caboose
boondoggle	boondoggle
swingman	swingman
provolone	provolone
photosphere	photosphere
stoner	stoner
rezoning	rezoning
stingray	stingray
zookeeper	zookeeper
credenza	credenza
gorgonzola	gorgonzola
hottie	hottie
peeve	peeve
narcissist	narcissist
cybersecurity	cybersecurity
catchall	catchall
mudroom	mudroom
orthopedist	orthopedist
bundt	bundt
spiderweb	spiderweb
videographer	videographer
homeschooling	homeschooling
pitchman	pitchman
preproduction	preproduction
birdhouse	birdhouse
bobber	bobber
newbie	newbie
bleacher	bleacher
burg	burg
ceramist	ceramist
sanitarium	sanitarium
halfpipe	halfpipe
cellblock	cellblock
boomtown	boomtown
snowbank	snowbank
roadbed	roadbed
chainring	chainring
doozy	doozy
preteen	preteen
pushback	pushback
morph	morph
beanie	beanie
racecar	racecar
cannoli	cannoli
strider	strider
ridgetop	ridgetop
soundstage	soundstage
jambalaya	jambalaya
watercooler	watercooler
ancho	ancho
preventer	preventer
infotech	infotech
clunker	clunker
cosmetology	cosmetology
trifecta	trifecta
pinup	pinup
feedlot	feedlot
stepparent	stepparent
superstardom	superstardom
gantlet	gantlet
timberland	timberland
likability	likability
temblor	temblor
multiverse	multiverse
colic	colic
garbanzo	garbanzo
dodgeball	dodgeball
telepresence	telepresence
bonobo	bonobo
pinwheel	pinwheel
housedress	housedress
sheetrock	sheetrock
teepee	teepee
soba	soba
collimation	collimation
kook	kook
veep	veep
carpaccio	carpaccio
shortcake	shortcake
anticorruption	anticorruption
tallgrass	tallgrass
hardtail	hardtail
packbag	packbag
puter	puter
aerie	aerie
updraft	updraft
brights	brights
deliveryman	deliveryman
semifinalist	semifinalist
skybox	skybox
shirtwaist	shirtwaist
homestand	homestand
moviegoer	moviegoer
daypack	daypack
goop	goop
rigatoni	rigatoni
criminalist	criminalist
freeride	freeride
starcraft	starcraft
houseguest	houseguest
timberline	timberline
sandhill	sandhill
overachiever	overachiever
roaster	roaster
anime	anime
tapenade	tapenade
bottler	bottler
gobble	gobble
tyrannosaur	tyrannosaur
crapshoot	crapshoot
spritz	spritz
pinata	pinata
mesclun	mesclun
toque	toque
hayride	hayride
showstopper	showstopper
windstorm	windstorm
gazillion	gazillion
jackknife	jackknife
dotcom	dotcom
nametag	nametag
hymnal	hymnal
estrus	estrus
goofball	goofball
highball	highball
wallboard	wallboard
nitroglycerin	nitroglycerin
uplink	uplink
upload	upload
patroller	patroller
oxycodone	oxycodone
grandstanding	grandstanding
roadkill	roadkill
anchorwoman	anchorwoman
takedown	takedown
challah	challah
barkeep	barkeep
spacewalk	spacewalk
hypoglycemia	hypoglycemia
terrarium	terrarium
topwater	topwater
bowhunter	bowhunter
schooler	schooler
raingear	raingear
snowsuit	snowsuit
gyno	gyno
zine	zine
rainfly	rainfly
subspace	subspace
andro	andro
thimerosal	thimerosal
castoff	castoff
falloff	falloff
pinon	pinon
fontina	fontina
panfish	panfish
tippet	tippet
crankbait	crankbait
eland	eland
quarterbacking	quarterbacking
whiner	whiner
lockbox	lockbox
inclusivity	inclusivity
aircar	aircar
archrival	archrival
fingerling	fingerling
sidewinder	sidewinder
subwoofer	subwoofer
exerciser	exerciser
buckboard	buckboard
neediness	neediness
mensch	mensch
tomatillo	tomatillo
teleportation	teleportation
pumper	pumper
lightsaber	lightsaber
rinderpest	rinderpest
shuffleboard	shuffleboard
nonpartisan	nonpartisan
roundtrip	roundtrip
feces	feces
tike	tike
biohazard	biohazard
touchpad	touchpad
airboat	airboat
coeditor	coeditor
uniter	uniter
stickball	stickball
deadfall	deadfall
backstretch	backstretch
mirin	mirin
rutabaga	rutabaga
tricorder	tricorder
savor	savor
tuneup	tuneup
assemblywoman	assemblywoman
tempura	tempura
showboat	showboat

word	lemma
provide	provide
include	include
create	create
support	support
consider	consider
lead	lead
remain	remain
develop	develop
appear	appear
suggest	suggest
reduce	reduce
produce	produce
require	require
increase	increase
determine	determine
improve	improve
state	state
focus	focus
receive	receive
teach	teach
tend	tend
recognize	recognize
control	control
identify	identify
maintain	maintain
describe	describe
exist	exist
address	address
seek	seek
represent	represent
argue	argue
form	form
apply	apply
affect	affect
achieve	achieve
occur	occur
ensure	ensure
indicate	indicate
perform	perform
reflect	reflect
assume	assume
encourage	encourage
report	report
note	note
test	test
establish	establish
participate	participate
promote	promote
experience	experience
study	study
gain	gain
reveal	reveal
examine	examine
present	present
contain	contain
explore	explore
engage	engage
fail	fail
benefit	benefit
result	result
contribute	contribute
complete	complete
operate	operate
expand	expand
define	define
demonstrate	demonstrate
express	express
influence	influence
compare	compare
view	view
assess	assess
involve	involve
measure	measure
rely	rely
pursue	pursue
extend	extend
obtain	obtain
generate	generate
predict	predict
depend	depend
enhance	enhance
preserve	preserve
exercise	exercise
investigate	investigate
account	account
communicate	communicate
limit	limit
emerge	emerge
acknowledge	acknowledge
conduct	conduct
challenge	challenge
vary	vary
refer	refer
capture	capture
evaluate	evaluate
assist	assist
adopt	adopt
overcome	overcome
process	process
guide	guide
relate	relate
resolve	resolve
attempt	attempt
observe	observe
differ	differ
enable	enable
emphasize	emphasize
monitor	monitor
review	review
accomplish	accomplish
select	select
implement	implement
permit	permit
justify	justify
confirm	confirm
detect	detect
organize	organize
accommodate	accommodate
analyze	analyze
yield	yield
acquire	acquire
lack	lack
proceed	proceed
retain	retain
display	display
impose	impose
alter	alter
sustain	sustain
confront	confront
facilitate	facilitate
conclude	conclude
design	design
advance	advance
transform	transform
distinguish	distinguish
perceive	perceive
construct	construct
constitute	constitute
cope	cope
supply	supply
strengthen	strengthen
arise	arise
pose	pose
possess	possess
function	function
minimize	minimize
access	access
satisfy	satisfy
graduate	graduate
estimate	estimate
research	research
interpret	interpret
inform	inform
locate	locate
incorporate	incorporate
dominate	dominate
shape	shape
illustrate	illustrate
reject	reject
direct	direct
employ	employ
enforce	enforce
educate	educate
link	link
interact	interact
propose	propose
submit	submit
regulate	regulate
regard	regard
encounter	encounter
convey	convey
publish	publish
adapt	adapt
fulfill	fulfill
translate	translate
contend	contend
exhibit	exhibit
peer	peer
program	program
occupy	occupy
comply	comply
undermine	undermine
exceed	exceed
decrease	decrease
stimulate	stimulate
integrate	integrate
interfere	interfere
counter	counter
foster	foster
reinforce	reinforce
stress	stress
grade	grade
imply	imply
clarify	clarify
accompany	accompany
compensate	compensate
highlight	highlight
intervene	intervene
aid	aid
assert	assert
evolve	evolve
calculate	calculate
restrict	restrict
exploit	exploit
decline	decline
stem	stem
violate	violate
govern	govern
maximize	maximize
advocate	advocate
cite	cite
characterize	characterize
undergo	undergo
associate	associate
manipulate	manipulate
initiate	initiate
portray	portray
project	project
devote	devote
render	render
prevail	prevail
modify	modify
exclude	exclude
diminish	diminish
persist	persist
coordinate	coordinate
verify	verify
document	document
cease	cease
articulate	articulate
consist	consist
undertake	undertake
comprehend	comprehend
master	master
suppress	suppress
attain	attain
specify	specify
strive	strive
base	base
utilize	utilize
prohibit	prohibit
derive	derive
motivate	motivate
desire	desire
deter	deter
reproduce	reproduce
isolate	isolate
concern	concern
reconcile	reconcile
model	model
induce	induce
administer	administer
weaken	weaken
conform	conform
assign	assign
provoke	provoke
depict	depict
unite	unite
exert	exert
transmit	transmit
alleviate	alleviate
supplement	supplement
resource	resource
attribute	attribute
excel	excel
differentiate	differentiate
discern	discern
frame	frame
effect	effect
conceive	conceive
adhere	adhere
evoke	evoke
correspond	correspond
reside	reside
insure	insure
con	con
enroll	enroll
accumulate	accumulate
bind	bind
comprise	comprise
warrant	warrant
enact	enact
export	export
forge	forge
cultivate	cultivate
complement	complement
replicate	replicate
mobilize	mobilize
value	value
uphold	uphold
broaden	broaden
progress	progress
compose	compose
import	import
discriminate	discriminate
flourish	flourish
collaborate	collaborate
devise	devise
nurture	nurture
inhabit	inhabit
illuminate	illuminate
probe	probe
elicit	elicit
survey	survey
elaborate	elaborate
conserve	conserve
suffice	suffice
manifest	manifest
imitate	imitate
enrich	enrich
prompt	prompt
formulate	formulate
bridge	bridge
empower	empower
map	map
lessen	lessen
moderate	moderate
consolidate	consolidate
invoke	invoke
simulate	simulate
mitigate	mitigate
affirm	affirm
obscure	obscure
revise	revise
appropriate	appropriate
neglect	neglect
align	align
transcend	transcend
emulate	emulate
embody	embody
inhibit	inhibit
underscore	underscore
encompass	encompass
refine	refine
reconstruct	reconstruct
proclaim	proclaim
migrate	migrate
classify	classify
activate	activate
inquire	inquire
ascertain	ascertain
entail	entail
validate	validate
authorize	authorize
outline	outline
simplify	simplify
contradict	contradict
intercept	intercept
coincide	coincide
diagnose	diagnose
complicate	complicate
supervise	supervise
instruct	instruct
summarize	summarize
quantify	quantify
mediate	mediate
aspire	aspire
refrain	refrain
preclude	preclude
attest	attest
perpetuate	perpetuate
terminate	terminate
outweigh	outweigh
remedy	remedy
hinder	hinder
safeguard	safeguard
correlate	correlate
labor	labor
converge	converge
redefine	redefine
designate	designate
signify	signify
impede	impede
intensify	intensify
amend	amend
erode	erode
compel	compel
mirror	mirror
instill	instill
eradicate	eradicate
shear	shear
conflict	conflict
impact	impact
deepen	deepen
symbolize	symbolize
originate	originate
infer	infer
confer	confer
merit	merit
vie	vie
deprive	deprive
equate	equate
distort	distort
enlarge	enlarge
infect	infect
assimilate	assimilate
allocate	allocate
circulate	circulate
restructure	restructure
discharge	discharge
relinquish	relinquish
counteract	counteract
socialize	socialize
exacerbate	exacerbate
rate	rate
cluster	cluster
improvise	improvise
coexist	coexist
curtail	curtail
span	span
furnish	furnish
solicit	solicit
grapple	grapple
generalize	generalize
impart	impart
disregard	disregard
augment	augment
term	term
compute	compute
modernize	modernize
contest	contest
overlap	overlap
reshape	reshape
degrade	degrade
categorize	categorize
displace	displace
revolve	revolve
optimize	optimize
deem	deem
unify	unify
absent	absent
arouse	arouse
equip	equip
circumvent	circumvent
compile	compile
refute	refute
underlie	underlie
heighten	heighten
constrain	constrain
renounce	renounce
code	code
confine	confine
denote	denote
redirect	redirect
intersect	intersect
incur	incur
concur	concur
rationalize	rationalize
tailor	tailor
disseminate	disseminate
legitimize	legitimize
prioritize	prioritize
synthesize	synthesize
destabilize	destabilize
publicize	publicize
accord	accord
precede	precede
reference	reference
lag	lag
forestall	forestall
approximate	approximate
reaffirm	reaffirm
subvert	subvert
ratify	ratify
solidify	solidify
partake	partake
paraphrase	paraphrase
reestablish	reestablish
reuse	reuse
format	format
amplify	amplify
infuse	infuse
diffuse	diffuse
content	content
hamper	hamper
exemplify	exemplify
decode	decode
reorganize	reorganize
outreach	outreach
accrue	accrue
err	err
consent	consent
commence	commence
lament	lament
expend	expend
orient	orient
obstruct	obstruct
engender	engender
profess	profess
interface	interface
frustrate	frustrate
propagate	propagate
underline	underline
rectify	rectify
negate	negate
internalize	internalize
sup	sup
accentuate	accentuate
decay	decay
soil	soil
delineate	delineate
posit	posit
detract	detract
corroborate	corroborate
implicate	implicate
impair	impair
reiterate	reiterate
substantiate	substantiate
reassess	reassess
conceptualize	conceptualize
espouse	espouse
pertain	pertain
further	further
predominate	predominate
proliferate	proliferate
sanction	sanction
abstain	abstain
pare	pare
diverge	diverge
overestimate	overestimate
confound	confound
redesign	redesign
deduce	deduce
procure	procure
fluctuate	fluctuate
interrogate	interrogate
deviate	deviate
theorize	theorize
ascribe	ascribe
petition	petition
coalesce	coalesce
recur	recur
precipitate	precipitate
innovate	innovate
ensue	ensue
emanate	emanate
expedite	expedite
necessitate	necessitate
ameliorate	ameliorate
sin	sin
coerce	coerce
repress	repress
delegate	delegate
permeate	permeate
cede	cede
redress	redress
fuse	fuse
elucidate	elucidate
reexamine	reexamine
excavate	excavate
persevere	persevere
reassert	reassert
supplant	supplant
normalize	normalize
annex	annex
forego	forego
allay	allay
divine	divine
emigrate	emigrate
familiarize	familiarize
eschew	eschew
extrapolate	extrapolate
invalidate	invalidate
apprehend	apprehend
harmonize	harmonize
hypothesize	hypothesize
surmise	surmise
discontinue	discontinue
colonize	colonize
preempt	preempt
magnify	magnify
equal	equal
detach	detach
standardize	standardize
reprint	reprint
parallel	parallel
situate	situate
abstract	abstract
endeavor	endeavor
ail	ail
redistribute	redistribute
deplete	deplete
dramatize	dramatize
abate	abate
repudiate	repudiate
retard	retard
fabricate	fabricate
binge	binge
allude	allude
index	index
disengage	disengage
reevaluate	reevaluate
denigrate	denigrate
decry	decry
exile	exile
avail	avail
encode	encode
compost	compost
re-examine	re-examine
embed	embed
institutionalize	institutionalize
animate	animate
dissent	dissent
site	site
appraise	appraise
purport	purport
equalize	equalize
culminate	culminate
decompose	decompose
group	group
reciprocate	reciprocate
manure	manure
segregate	segregate
acquiesce	acquiesce
devalue	devalue
hew	hew
rework	rework
infringe	infringe
condense	condense
endow	endow
reconfigure	reconfigure
ally	ally
configure	configure
disparage	disparage
bias	bias
deconstruct	deconstruct
brainstorm	brainstorm
reinvigorate	reinvigorate
arc	arc
reconstitute	reconstitute
calibrate	calibrate
distance	distance
recast	recast
marginalize	marginalize
construe	construe
buttress	buttress
overlay	overlay
mistrust	mistrust
liberalize	liberalize
narrate	narrate
buffer	buffer
monopolize	monopolize
humanize	humanize
structure	structure
query	query
pacify	pacify
supersede	supersede
oppress	oppress
co-opt	co-opt
postulate	postulate
divest	divest
predate	predate
misrepresent	misrepresent
democratize	democratize
impinge	impinge
countenance	countenance
incarnate	incarnate
transcribe	transcribe
pervade	pervade
portend	portend
predispose	predispose
vindicate	vindicate
nullify	nullify
modulate	modulate
recognise	recognise
accede	accede
commercialize	commercialize
usurp	usurp
resettle	resettle
inculcate	inculcate
subsist	subsist
acquaint	acquaint
presuppose	presuppose
co-exist	co-exist
surmount	surmount
gall	gall
relegate	relegate
archive	archive
promulgate	promulgate
input	input
verbalize	verbalize
disentangle	disentangle
immigrate	immigrate
decree	decree
epitomize	epitomize
underpin	underpin
envisage	envisage
explicate	explicate
disavow	disavow
litigate	litigate
crystallize	crystallize
foment	foment
counterbalance	counterbalance
codify	codify
reframe	reframe
nationalize	nationalize
fragment	fragment
adjudicate	adjudicate
moot	moot
encroach	encroach
imbue	imbue
reorient	reorient
retell	retell
relapse	relapse
inscribe	inscribe
obviate	obviate
typify	typify
reinterpret	reinterpret
foreshadow	foreshadow
juxtapose	juxtapose
disassociate	disassociate
aggregate	aggregate
straggle	straggle
contextualize	contextualize
realise	realise
authenticate	authenticate
encapsulate	encapsulate
interconnect	interconnect
demystify	demystify
admonish	admonish
prophesy	prophesy
polarize	polarize
abdicate	abdicate
personify	personify
parody	parody
transpire	transpire
centralize	centralize
veil	veil
devolve	devolve
instigate	instigate
connote	connote
proselytize	proselytize
regress	regress
reactivate	reactivate
formalize	formalize
pique	pique
consummate	consummate
reenact	reenact
foretell	foretell
deform	deform
operationalize	operationalize
extol	extol
partition	partition
consign	consign
digitize	digitize
comport	comport
conflate	conflate
falsify	falsify
condition	condition
enjoin	enjoin
sludge	sludge
sensitize	sensitize
practise	practise
intertwine	intertwine
idealize	idealize
bracket	bracket
naturalize	naturalize
invigorate	invigorate
repatriate	repatriate
unsettle	unsettle
microfilm	microfilm
enumerate	enumerate
exalt	exalt
catalogue	catalogue
reintegrate	reintegrate
transgress	transgress
debrief	debrief
dissociate	dissociate
unmask	unmask
stigmatize	stigmatize
superimpose	superimpose
fulfil	fulfil
oscillate	oscillate
remediate	remediate
localize	localize
evince	evince
attenuate	attenuate
gratify	gratify
respite	respite
subsume	subsume
subjugate	subjugate
procreate	procreate
decentralize	decentralize
reorder	reorder
resound	resound
stagnate	stagnate
obligate	obligate
abrogate	abrogate
oversimplify	oversimplify
abet	abet
tract	tract
presage	presage
reformulate	reformulate
cohere	cohere
exhort	exhort
forearm	forearm
analyse	analyse
output	output
enunciate	enunciate
catalyze	catalyze
fixate	fixate
actualize	actualize
overemphasize	overemphasize
enshrine	enshrine
contrive	contrive
unlearn	unlearn
conjecture	conjecture
entrap	entrap
caricature	caricature
reemerge	reemerge
de-emphasize	de-emphasize
augur	augur
apportion	apportion
delegitimize	delegitimize
officiate	officiate
photocopy	photocopy
civilize	civilize
silt	silt
transpose	transpose
disillusion	disillusion
demarcate	demarcate
impute	impute
tile	tile
trawl	trawl
bespeak	bespeak
individualize	individualize
metamorphose	metamorphose
allot	allot
occult	occult
infest	infest
objectify	objectify
troubleshoot	troubleshoot
undergird	undergird
domesticate	domesticate
sanctify	sanctify
ape	ape
impel	impel
entangle	entangle
oxidize	oxidize
inactivate	inactivate
disallow	disallow
subdivide	subdivide
entrench	entrench
rend	rend
lope	lope
reallocate	reallocate
contravene	contravene
debug	debug
circumscribe	circumscribe
co-ordinate	co-ordinate
dehumanize	dehumanize
evangelize	evangelize
conch	conch
indoctrinate	indoctrinate
subtitle	subtitle
depreciate	depreciate
preoccupy	preoccupy
obfuscate	obfuscate
collude	collude
defame	defame
industrialize	industrialize
recapitulate	recapitulate
interweave	interweave
emancipate	emancipate
elapse	elapse
repopulate	repopulate
annul	annul
tabulate	tabulate
remit	remit
castigate	castigate
abridge	abridge
arbitrate	arbitrate
disburse	disburse
impoverish	impoverish
internationalize	internationalize
consecrate	consecrate
triangulate	triangulate
reify	reify
class	class
refashion	refashion
purpose	purpose
militate	militate
delimit	delimit
molt	molt
vex	vex
retrograde	retrograde
favour	favour
intermingle	intermingle
recombine	recombine
metastasize	metastasize
reconceptualize	reconceptualize
efface	efface
professionalize	professionalize
reimagine	reimagine
debase	debase
transmute	transmute
transact	transact
section	section
assent	assent
misconstrue	misconstrue
repose	repose
problematize	problematize
matriculate	matriculate
emphasise	emphasise
effectuate	effectuate
aver	aver
enquire	enquire
satirize	satirize
solder	solder
verse	verse
radicalize	radicalize
systematize	systematize
subgroup	subgroup
illumine	illumine
hemorrhage	hemorrhage
resubmit	resubmit
inhere	inhere
self-regulate	self-regulate
pervert	pervert
disclaim	disclaim
leer	leer
notate	notate
aggress	aggress
externalize	externalize
expropriate	expropriate
append	append
reconfirm	reconfirm
reunify	reunify
self-identify	self-identify
reengage	reengage
privilege	privilege
interrelate	interrelate
ornament	ornament
disfigure	disfigure
disaggregate	disaggregate
cohabit	cohabit
coagulate	coagulate
honour	honour
outcompete	outcompete
apprise	apprise
sequence	sequence
interpose	interpose
proscribe	proscribe
audiate	audiate
co-operate	co-operate
demobilize	demobilize
reengineer	reengineer
co-occur	co-occur
nom	nom
homogenize	homogenize
depoliticize	depoliticize
problem-solve	problem-solve
interlace	interlace
attune	attune
philosophize	philosophize
legitimate	legitimate
mystify	mystify
lave	lave
conjugate	conjugate
undervalue	undervalue
intermarry	intermarry
major	major
canonize	canonize
underreport	underreport
occlude	occlude
indemnify	indemnify
refract	refract
decontrol	decontrol
accrete	accrete
bootstrap	bootstrap
re-think	re-think
deemphasize	deemphasize
reimpose	reimpose
minimise	minimise
regularize	regularize
decontaminate	decontaminate
accredit	accredit
reoccur	reoccur
encumber	encumber
prefigure	prefigure
valorize	valorize
organise	organise
relativize	relativize
sight-read	sight-read
bobble	bobble
underplay	underplay
commingle	commingle
extrude	extrude
universalize	universalize
historicize	historicize
annotate	annotate
encore	encore
biodegrade	biodegrade
overwrite	overwrite
satiate	satiate
ennoble	ennoble
self-administer	self-administer
emasculate	emasculate
predicate	predicate
vitiate	vitiate
avow	avow
hybridize	hybridize
spindle	spindle
predetermine	predetermine
truncate	truncate
secularize	secularize
redound	redound
excommunicate	excommunicate
acculturate	acculturate
decouple	decouple
voyage	voyage
underrate	underrate
revalue	revalue
pupate	pupate
fledge	fledge
remand	remand
parasitize	parasitize
sieve	sieve
instantiate	instantiate
remix	remix
stratify	stratify
overfeed	overfeed
elide	elide
propound	propound
conjoin	conjoin
rebury	rebury
interleave	interleave
edify	edify
interpolate	interpolate
overstretch	overstretch
interplay	interplay
reanimate	reanimate
decolonize	decolonize
reemphasize	reemphasize
prise	prise
re-use	re-use
underachieve	underachieve
supercede	supercede
cauterize	cauterize
perplex	perplex
purvey	purvey
disempower	disempower
de-escalate	de-escalate
globalize	globalize
exculpate	exculpate
shew	shew
excoriate	excoriate
adduce	adduce
mesh	mesh
debilitate	debilitate
blaspheme	blaspheme
inseminate	inseminate
opiate	opiate
extirpate	extirpate
lactate	lactate
abjure	abjure
countermand	countermand
subculture	subculture
photosynthesize	photosynthesize
forbear	forbear
commun	commun
restage	restage
recolonize	recolonize
habituate	habituate
expiate	expiate
assay	assay
plough	plough
inflect	inflect
pathologize	pathologize
analogize	analogize
propagandize	propagandize
concretize	concretize
liaise	liaise
dispossess	dispossess
conduce	conduce
ambulate	ambulate
depersonalize	depersonalize
exasperate	exasperate
propitiate	propitiate
aspirate	aspirate
reconceive	reconceive
misdirect	misdirect
reexperience	reexperience
disconfirm	disconfirm
pretest	pretest
re-register	re-register
self-assess	self-assess
reconquer	reconquer
irradiate	irradiate
mechanize	mechanize
seclude	seclude
atomize	atomize
amalgamate	amalgamate
conciliate	conciliate
disfavor	disfavor
mythologize	mythologize
silhouette	silhouette
particularize	particularize
re-present	re-present
deify	deify
self-publish	self-publish
occasion	occasion
burgeon	burgeon
disconcert	disconcert
fetishize	fetishize
commodify	commodify
misperceive	misperceive
postdate	postdate
reenlist	reenlist
transfigure	transfigure
fictionalize	fictionalize
overrate	overrate
sentinel	sentinel
proportion	proportion
countervail	countervail
denude	denude
eventuate	eventuate
estrange	estrange
betoken	betoken
packet	packet
reabsorb	reabsorb
premise	premise
misspell	misspell
labour	labour
re-write	re-write
maximise	maximise
randomize	randomize
tape-record	tape-record
bifurcate	bifurcate
individuate	individuate
coopt	coopt
slight	slight
misidentify	misidentify
batch	batch
re-learn	re-learn
reanalyze	reanalyze
thematize	thematize
bewail	bewail
self-disclose	self-disclose
congest	congest
revivify	revivify
anthropomorphize	anthropomorphize
outfight	outfight
ritualize	ritualize
deprecate	deprecate
out-compete	out-compete
utilise	utilise
tyrannize	tyrannize
initialize	initialize
interpenetrate	interpenetrate
arrogate	arrogate
potentiate	potentiate
aggrandize	aggrandize
misinform	misinform
criticise	criticise
obtrude	obtrude
urbanize	urbanize
self-evaluate	self-evaluate
entrain	entrain
vivify	vivify
scruple	scruple
deselect	deselect
narrativize	narrativize
self-address	self-address
balkanize	balkanize
distend	distend
pre-date	pre-date
preload	preload
remap	remap
manoeuvre	manoeuvre
beset	beset
reinscribe	reinscribe
recontextualize	recontextualize
self-organize	self-organize
re-orient	re-orient
bioaccumulate	bioaccumulate
uncouple	uncouple
actuate	actuate
recompose	recompose
signpost	signpost
dichotomize	dichotomize
undercount	undercount
incise	incise
characterise	characterise
re-assess	re-assess
vitalize	vitalize
palpate	palpate
delist	delist
refigure	refigure
overgrow	overgrow
expatiate	expatiate
derogate	derogate
respire	respire
stultify	stultify
re-export	re-export
self-gift	self-gift
souvent	souvent
inveigh	inveigh
recommence	recommence
demythologize	demythologize
team-teach	team-teach
sabe	sabe
co-teach	co-teach
co-create	co-create
optimise	optimise
equilibrate	equilibrate
disquiet	disquiet
enmesh	enmesh
prognosticate	prognosticate
reincorporate	reincorporate
overstress	overstress
reteach	reteach
adsorb	adsorb
denuclearize	denuclearize
precess	precess
recode	recode
subsample	subsample
word	lemma
said	say
came	come
got	get
went	go
made	make
took	take
thought	think
knew	know
told	tell
saw	see
wanted	want
asked	ask
found	find
began	begin
looked	look
felt	feel
became	become
started	start
gave	give
turned	turn
seemed	seem
left	leave
happened	happen
tried	try
wrote	write
heard	hear
sat	sit
called	call
stood	stand
died	die
showed	show
put	put
ran	run
worked	work
used	use
walked	walk
kept	keep
needed	need
held	hold
decided	decide
brought	bring
moved	move
lost	lose
fell	fall
opened	open
won	win
grew	grow
spoke	speak
met	meet
spent	spend
hit	hit
appeared	appear
reported	report
played	play
pulled	pull
watched	watch
led	lead
continued	continue
received	receive
lived	live
stopped	stop
helped	help
meant	mean
included	include
reached	reach
added	add
learned	learn
sent	send
passed	pass
set	set
loved	love
realized	realize
followed	follow
talked	talk
broke	break
believed	believe
liked	like
smiled	smile
shook	shake
bought	buy
arrived	arrive
nodded	nod
agreed	agree
picked	pick
offered	offer
returned	return
drove	drive
remained	remain
ended	end
suggested	suggest
closed	close
raised	raise
lay	lay
announced	announce
caught	catch
discovered	discover
laughed	laugh
named	name
wore	wear
pointed	point
created	create
explained	explain
killed	kill
joined	join
chose	choose
wondered	wonder
dropped	drop
changed	change
occurred	occur
threw	throw
waited	wait
failed	fail
stared	stare
served	serve
drew	draw
stayed	stay
read	read
indicated	indicate
noted	note
paid	pay
stepped	step
described	describe
pushed	push
shot	shoot
carried	carry
entered	enter
allowed	allow
noticed	notice
remembered	remember
replied	reply
refused	refuse
mentioned	mention
sold	sell
involved	involve
signed	sign
answered	answer
finished	finish
built	build
expected	expect
revealed	reveal
considered	consider
understood	understand
produced	produce
managed	manage
claimed	claim
provided	provide
leaned	lean
caused	cause
ate	eat
glanced	glance
sought	seek
taught	teach
missed	miss
ordered	order
jumped	jump
struck	strike
emerged	emerge
developed	develop
cried	cry
insisted	insist
grabbed	grab
flew	fly
argued	argue
whispered	whisper
sounded	sound
hung	hang
studied	study
scored	score
lifted	lift
covered	cover
visited	visit
proved	prove
rolled	roll
concluded	conclude
touched	touch
hoped	hope
promised	promise
figured	figure
filled	fill
recognized	recognize
disappeared	disappear
attended	attend
declared	declare
shouted	shout
earned	earn
handed	hand
slipped	slip
recalled	recall
enjoyed	enjoy
paused	pause
stated	state
shrugged	shrug
fought	fight
climbed	climb
approached	approach
blew	blow
voted	vote
represented	represent
presented	present
beat	beat
let	let
shared	share
introduced	introduce
listened	listen
crossed	cross
supported	support
woke	wake
wished	wish
responded	respond
published	publish
sighed	sigh
faced	face
suffered	suffer
hated	hate
declined	decline
forced	force
reminded	remind
warned	warn
observed	observe
demanded	demand
admitted	admit
completed	complete
established	establish
traveled	travel
existed	exist
laid	lay
sang	sing
formed	form
married	marry
checked	check
examined	examine
launched	launch
slept	sleep
slid	slide
complained	complain
planned	plan
increased	increase
forgot	forget
issued	issue
pressed	press
accepted	accept
contained	contain
expressed	express
intended	intend
settled	settle
fired	fire
saved	save
assumed	assume
rode	ride
drank	drink
owned	own
hired	hire
snapped	snap
waved	wave
repeated	repeat
conducted	conduct
survived	survive
removed	remove
imagined	imagine
performed	perform
placed	place
gained	gain
invited	invite
proposed	propose
tested	test
focused	focus
tended	tend
experienced	experience
rang	ring
participated	participate
shut	shut
yelled	yell
stuck	stick
kissed	kiss
demonstrated	demonstrate
filed	file
threatened	threaten
discussed	discuss
belonged	belong
landed	land
ignored	ignore
urged	urge
smelled	smell
denied	deny
bent	bend
stole	steal
rejected	reject
chopped	chop
retired	retire
kicked	kick
confirmed	confirm
gathered	gather
reflected	reflect
struggled	struggle
acknowledged	acknowledge
knocked	knock
ruled	rule
hurt	hurt
catches	catch
founded	found
delivered	deliver
contributed	contribute
feared	fear
lasted	last
testified	testify
attempted	attempt
grinned	grin
accused	accuse
headed	head
stretched	stretch
recorded	record
poured	pour
rushed	rush
encouraged	encourage
tied	tie
backed	back
cited	cite
burned	burn
extended	extend
swung	swing
adopted	adopt
lit	light
predicted	predict
attacked	attack
designed	design
tossed	toss
collected	collect
perceived	perceive
wrapped	wrap
devoted	devote
recommended	recommend
cleared	clear
lowered	lower
interviewed	interview
destroyed	destroy
shifted	shift
lacked	lack
organized	organize
reduced	reduce
directed	direct
muttered	mutter
screamed	scream
prompted	prompt
captured	capture
frowned	frown
estimated	estimate
charged	charge
lied	lie
dug	dig
replaced	replace
fled	flee
compared	compare
sank	sink
applied	apply
informed	inform
rubbed	rub
wiped	wipe
addressed	address
swept	sweep
maintained	maintain
exploded	explode
hesitated	hesitate
fed	feed
tore	tear
preferred	prefer
worried	worry
graduated	graduate
slammed	slam
approved	approve
bit	bite
cut	cut
crashed	crash
favored	favor
flashed	flash
spotted	spot
rated	rate
emphasized	emphasize
wound	wind
blinked	blink
dragged	drag
acted	act
assured	assure
identified	identify
convinced	convince
suspected	suspect
hid	hide
abandoned	abandon
inspired	inspire
opposed	oppose
viewed	view
arose	arise
combined	combine
resulted	result
locked	lock
acquired	acquire
spread	spread
surprised	surprise
referred	refer
questioned	question
stumbled	stumble
drifted	drift
cared	care
vanished	vanish
defined	define
purchased	purchase
featured	feature
averaged	average
released	release
gazed	gaze
hurried	hurry
quit	quit
controlled	control
switched	switch
peered	peer
searched	search
counted	count
mixed	mix
murmured	murmur
squeezed	squeeze
tapped	tap
withdrew	withdraw
challenged	challenge
collapsed	collapse
packed	pack
employed	employ
measured	measure
washed	wash
practiced	practice
dismissed	dismiss
advised	advise
enabled	enable
deserved	deserve
pleaded	plead
centered	center
swallowed	swallow
reviewed	review
brushed	brush
resigned	resign
handled	handle
seized	seize
attracted	attract
criticized	criticize
sensed	sense
escaped	escape
proceeded	proceed
obtained	obtain
breathed	breathe
popped	pop
blamed	blame
interrupted	interrupt
surveyed	survey
weighed	weigh
related	relate
invented	invent
hugged	hug
displayed	display
posted	post
arranged	arrange
prayed	pray
dreamed	dream
painted	paint
dominated	dominate
labeled	label
flipped	flip
listed	list
defended	defend
yielded	yield
generated	generate
witnessed	witness
colored	color
analyzed	analyze
spun	spin
exclaimed	exclaim
embraced	embrace
froze	freeze
slowed	slow
aimed	aim
greeted	greet
confessed	confess
succeeded	succeed
underwent	undergo
commented	comment
expanded	expand
slapped	slap
bounced	bounce
patted	pat
shoved	shove
stressed	stress
remarked	remark
avoided	avoid
asserted	assert
treated	treat
located	locate
pretended	pretend
raced	race
defeated	defeat
possessed	possess
guessed	guess
required	require
surrounded	surround
tucked	tuck
investigated	investigate
relaxed	relax
twisted	twist
posed	pose
committed	commit
sliced	slice
praised	praise
protested	protest
granted	grant
contacted	contact
violated	violate
gasped	gasp
blocked	block
pitched	pitch
rested	rest
wandered	wander
eased	ease
gestured	gesture
shone	shine
accompanied	accompany
prevented	prevent
knelt	kneel
thanked	thank
melted	melt
sued	sue
marched	march
traded	trade
admired	admire
quoted	quote
celebrated	celebrate
installed	install
divided	divide
parked	park
transformed	transform
disagreed	disagree
danced	dance
cooked	cook
chuckled	chuckle
vowed	vow
begged	beg
sprang	spring
swam	swim
apologized	apologize
prepared	prepare
owed	owe
glared	glare
resembled	resemble
cleaned	clean
enlisted	enlist
reacted	react
exposed	expose
swore	swear
jerked	jerk
smoked	smoke
clicked	click
triggered	trigger
welcomed	welcome
uncovered	uncover
straightened	straighten
scared	scare
dealt	deal
cost	cost
roared	roar
shocked	shock
cracked	crack
recovered	recover
mattered	matter
grated	grate
encountered	encounter
bore	bore
stirred	stir
improved	improve
bowed	bow
crowded	crowd
tasted	taste
punched	punch
scanned	scan
inherited	inherit
echoed	echo
resisted	resist
volunteered	volunteer
circled	circle
marked	mark
awoke	awake
bothered	bother
pounded	pound
dumped	dump
diced	dice
engaged	engage
persuaded	persuade
crept	creep
pursued	pursue
doubled	double
strode	stride
leaped	leap
envisioned	envision
exchanged	exchange
gripped	grip
soared	soar
explored	explore
ripped	rip
exceeded	exceed
illustrated	illustrate
stuffed	stuff
joked	joke
burst	burst
split	split
exhibited	exhibit
tracked	track
poked	poke
selected	select
signaled	signal
oriented	orient
resumed	resume
rented	rent
doubted	doubt
borrowed	borrow
sipped	sip
retreated	retreat
initiated	initiate
endorsed	endorse
endured	endure
trailed	trail
regarded	regard
floated	float
dried	dry
tilted	tilt
advanced	advance
plunged	plunge
tugged	tug
evolved	evolve
submitted	submit
composed	compose
yanked	yank
guided	guide
appreciated	appreciate
curled	curl
calculated	calculate
surfaced	surface
trusted	trust
invested	invest
confronted	confront
supposed	suppose
eliminated	eliminate
shaped	shape
groaned	groan
squinted	squint
permitted	permit
folded	fold
flung	fling
dared	dare
drained	drain
donated	donate
constituted	constitute
sparked	spark
mounted	mount
tipped	tip
hosted	host
characterized	characterize
relied	rely
commanded	command
faded	fade
conceded	concede
snorted	snort
topped	top
canceled	cancel
supplied	supply
amounted	amount
shivered	shiver
eyed	eye
consisted	consist
dressed	dress
crawled	crawl
fueled	fuel
pledged	pledge
invaded	invade
mumbled	mumble
ducked	duck
sailed	sail
wept	weep
bound	bind
instructed	instruct
piled	pile
snatched	snatch
rocked	rock
imposed	impose
sucked	suck
hissed	hiss
pictured	picture
scrambled	scramble
sniffed	sniff
whipped	whip
shuddered	shudder
tumbled	tumble
stroked	stroke
implied	imply
determined	determine
chased	chase
glowed	glow
murdered	murder
retained	retain
accomplished	accomplish
anticipated	anticipate
scratched	scratch
targeted	target
leapt	leap
buried	bury
descended	descend
wounded	wound
united	unite
narrowed	narrow
skipped	skip
attributed	attribute
injured	injure
appealed	appeal
modeled	model
stripped	strip
growled	growl
hovered	hover
secured	secure
startled	startle
varied	vary
decreased	decrease
crushed	crush
requested	request
hauled	haul
lingered	linger
detected	detect
unveiled	unveil
enrolled	enroll
tightened	tighten
freed	free
planted	plant
divorced	divorce
competed	compete
outlined	outline
rounded	round
boarded	board
clutched	clutch
spilled	spill
boasted	boast
resolved	resolve
phoned	phone
registered	register
sped	speed
evaluated	evaluate
traced	trace
reasoned	reason
nestled	nestle
persisted	persist
grunted	grunt
lent	lend
loomed	loom
winked	wink
consumed	consume
barked	bark
condemned	condemn
surged	surge
blasted	blast
honored	honor
corrected	correct
strolled	stroll
starred	star
stunned	stun
cheered	cheer
singled	single
appointed	appoint
reversed	reverse
opted	opt
trained	train
staged	stage
achieved	achieve
sponsored	sponsor
delayed	delay
flowed	flow
trembled	tremble
impressed	impress
giggled	giggle
flickered	flicker
advocated	advocate
licked	lick
concentrated	concentrate
stormed	storm
objected	object
clapped	clap
thrust	thrust
crafted	craft
negotiated	negotiate
cocked	cock
reinforced	reinforce
preceded	precede
flooded	flood
depicted	depict
highlighted	highlight
converted	convert
differed	differ
cursed	curse
ached	ache
darted	dart
pronounced	pronounce
assembled	assemble
coached	coach
departed	depart
ceased	cease
judged	judge
inquired	inquire
dipped	dip
chewed	chew
dedicated	dedicate
shuffled	shuffle
devised	devise
grasped	grasp
winced	wince
teased	tease
fixed	fix
crouched	crouch
clung	cling
recounted	recount
betrayed	betray
seeded	seed
countered	counter
suspended	suspend
flared	flare
erupted	erupt
flourished	flourish
slumped	slump
longed	long
stabbed	stab
respected	respect
translated	translate
smashed	smash
swirled	swirl
unfolded	unfold
rattled	rattle
desired	desire
summoned	summon
aired	air
ranged	range
carved	carve
steered	steer
overcame	overcome
documented	document
hopped	hop
toured	tour
bumped	bump
occupied	occupy
commissioned	commission
affected	affect
sealed	seal
assisted	assist
moaned	moan
awaited	await
flicked	flick
provoked	provoke
interpreted	interpret
widened	widen
blurted	blurt
proclaimed	proclaim
sustained	sustain
denounced	denounce
fluttered	flutter
ruined	ruin
totaled	total
staggered	stagger
originated	originate
contended	contend
comprised	comprise
operated	operate
drafted	draft
shattered	shatter
shrank	shrink
guaranteed	guarantee
lined	line
drowned	drown
edged	edge
choked	choke
motioned	motion
adjusted	adjust
pumped	pump
separated	separate
coughed	cough
parted	part
coincided	coincide
risked	risk
speculated	speculate
altered	alter
fished	fish
spat	spit
mused	muse
regretted	regret
screwed	screw
grumbled	grumble
draped	drape
warmed	warm
emitted	emit
wasted	waste
undertook	undertake
whistled	whistle
lurched	lurch
halted	halt
dialed	dial
leveled	level
pleased	please
whirled	whirl
spelled	spell
accelerated	accelerate
restored	restore
cautioned	caution
matched	match
reserved	reserve
paced	pace
neared	near
ventured	venture
panicked	panic
buzzed	buzz
photographed	photograph
conceived	conceive
battled	battle
elected	elect
dashed	dash
nudged	nudge
prevailed	prevail
oversaw	oversee
adapted	adapt
clenched	clench
banned	ban
progressed	progress
scooped	scoop
robbed	rob
valued	value
depended	depend
alleged	allege
strained	strain
surrendered	surrender
regained	regain
ranked	rank
promoted	promote
cast	cast
based	base
flushed	flush
chatted	chat
heaved	heave
housed	house
overlooked	overlook
stemmed	stem
executed	execute
adored	adore
rescued	rescue
edited	edit
paralyzed	paralyze
emptied	empty
functioned	function
disliked	dislike
accounted	account
hooked	hook
termed	term
benefited	benefit
peeked	peek
summed	sum
framed	frame
reiterated	reiterate
debated	debate
seated	seat
debuted	debut
gleamed	gleam
dawned	dawn
voiced	voice
clustered	cluster
banged	bang
enacted	enact
relieved	relieve
resented	resent
marveled	marvel
unlocked	unlock
excluded	exclude
shipped	ship
rallied	rally
trimmed	trim
plucked	pluck
fumbled	fumble
scraped	scrape
roamed	roam
dated	date
scowled	scowl
plummeted	plummet
pondered	ponder
suited	suit
inhaled	inhale
arrested	arrest
expired	expire
transferred	transfer
raged	rage
absorbed	absorb
lamented	lament
squatted	squat
consulted	consult
stalled	stall
hummed	hum
grimaced	grimace

word	lemma
very	very
voice	voice
view	view
value	value
various	various
video	video
violence	violence
values	value
very	very
vision	vision
variety	variety
version	version
voters	voter
vice	vice
vote	vote
village	village
valley	valley
visit	visit
victory	victory
victims	victim
views	view
vs	vs
visual	visual
vote	vote
vast	vast
vehicle	vehicle
visit	visit
variables	variable
virtually	virtually
victim	victim
violent	violent
votes	vote
visitors	visitor
visible	visible
voices	voice
via	via
volume	volume
vehicles	vehicle
valuable	valuable
vegetables	vegetable
vital	vital
vulnerable	vulnerable
versus	versus
vacation	vacation
view	view
veterans	veteran
virus	virus
volunteers	volunteer
viewed	view
visited	visit
voting	voting
viewers	viewer
visits	visit
virtual	virtual
vary	vary
versions	version
voted	vote
vegetable	vegetable
van	van
verbal	verbal
villages	village
variable	variable
validity	validity
visiting	visiting
variation	variation
venture	venture
visitor	visitor
vertical	vertical
voted	vote
vessels	vessel
virtue	virtue
volunteer	volunteer
verdict	verdict
vice	vice
videos	video
valid	valid
violation	violation
variance	variance
variations	variation
vitamin	vitamin
vinegar	vinegar
violations	violation
veteran	veteran
veteran	veteran
voluntary	voluntary
vessel	vessel
vaccine	vaccine
varieties	variety
vocal	vocal
vanilla	vanilla
viable	viable
vacuum	vacuum
vague	vague
varying	varying
vocabulary	vocabulary
vintage	vintage
viewer	viewer
voter	voter
visited	visit
vivid	vivid
victories	victory
visiting	visit
videotape	videotape
viewing	viewing
vietnamese	vietnamese
visually	visually
vendors	vendor
volumes	volume
virgin	virgin
visions	vision
vegetation	vegetation
velvet	velvet
varied	varied
victorian	victorian
vigorous	vigorous
villagers	villager
valued	value
vicious	vicious
viewed	view
vulnerability	vulnerability
vibrant	vibrant
volunteer	volunteer
ventures	venture
vanished	vanish
varies	vary
viruses	virus
vacant	vacant
volatile	volatile
virtues	virtue
verge	verge
vaguely	vaguely
verse	verse
visa	visa
violate	violate
velocity	velocity
veins	vein
visibility	visibility
vitamins	vitamin
void	void
vigorously	vigorously
veto	veto
violin	violin
variability	variability
voluntarily	voluntarily
vocational	vocational
venue	venue
variable	variable
voyage	voyage
vampire	vampire
vanity	vanity
vastly	vastly
villa	villa
violating	violate
vain	vain
vest	vest
vein	vein
valve	valve
volleyball	volleyball
vines	vine
verify	verify
volcano	volcano
venture	venture
violently	violently
voice	voice
vodka	vodka
viewpoint	viewpoint
veil	veil
violated	violate
valleys	valley
venues	venue
vacations	vacation
varied	vary
violated	violate
versatile	versatile
volcanic	volcanic
vikings	viking
vowed	vow
vitality	vitality
vaccines	vaccine
vegetarian	vegetarian
vase	vase
vengeance	vengeance
vendor	vendor
vineyard	vineyard
viewing	view
vine	vine
volunteered	volunteer
views	view
visionary	visionary
visits	visit
vantage	vantage
virgin	virgin
victimization	victimization
vet	vet
viral	viral
voting	vote
vanguard	vanguard
vapor	vapor
vault	vault
vinyl	vinyl
vividly	vividly
vanished	vanish
vicinity	vicinity
ventilation	ventilation
validation	validation
vibration	vibration
visibly	visibly
vouchers	voucher
voltage	voltage
vanish	vanish
valves	valve
vigor	vigor
value	value
varsity	varsity
venerable	venerable
veto	veto
verses	verse
vent	vent
villain	villain
vogue	vogue
vineyards	vineyard
viability	viability
visas	visa
verb	verb
verification	verification
viewpoints	viewpoint
varied	vary
violates	violate
vocation	vocation
videotapes	videotape
vinaigrette	vinaigrette
vomiting	vomit
vans	van
variant	variant
vector	vector
vascular	vascular
vigil	vigil
voucher	voucher
visitation	visitation
vows	vow
vertically	vertically
vigilant	vigilant
vaccination	vaccination
volunteering	volunteer
volatility	volatility
victorious	victorious
vulgar	vulgar
visualize	visualize
vents	vent
validate	validate
volcanoes	volcano
verbally	verbally
vampires	vampire
venetian	venetian
versatility	versatility
vibrations	vibration
vanishing	vanishing
veggies	veggie
vaginal	vaginal
voiced	voice
venom	venom
vegan	vegan
vow	vow
virtuous	virtuous
vice-president	vice-president
verified	verify
veal	veal
vases	vase
valuation	valuation
ventured	venture
volunteered	volunteer
veterinary	veterinary
vie	vie
vistas	vista
verbs	verb
valued	value
vagina	vagina
visceral	visceral
variously	variously
veritable	veritable
villains	villain
vibe	vibe
valet	valet
values	value
vying	vie
voiced	voice
vigilance	vigilance
vegetarian	vegetarian
variants	variant
vehemently	vehemently
victimized	victimize
vested	vested
vis-a-vis	vis-a-vis
veterinarian	veterinarian
vacancy	vacancy
vertigo	vertigo
vile	vile
vial	vial
voodoo	voodoo
veranda	veranda
vests	vest
visualization	visualization
vibrating	vibrate
vowed	vow
vets	vet
venezuelan	venezuelan
veneer	veneer
vandalism	vandalism
vending	vending
VIP	vip
vulnerabilities	vulnerability
vocals	vocals
verdicts	verdict
violet	violet
veiled	veiled
virulent	virulent
visor	visor
violinist	violinist
valued	valued
vista	vista
virginity	virginity
violet	violet
voicing	voice
vowels	vowel
vestibule	vestibule
validated	validate
video	video
veered	veer
valuing	value
vignettes	vignette
vetoed	veto
vacancies	vacancy
ventured	venture
vortex	vortex
veggie	veggie
vectors	vector
voluminous	voluminous
vowel	vowel
vows	vow
vanishes	vanish
varnish	varnish
vultures	vulture
venturing	venture
videotaped	videotaped
veer	veer
vent	vent
vegetative	vegetative
vacationing	vacation
valiant	valiant
venison	venison
vertebrae	vertebra
voyages	voyage
vials	vial
victor	victor
velocities	velocity
vernacular	vernacular
voracious	voracious
villas	villa
vindication	vindication
vestiges	vestige
vomit	vomit
vowing	vow
vagaries	vagaries
vernacular	vernacular
velvety	velvety
vocalist	vocalist
vegetarians	vegetarian
videotape	videotape
vices	vice
virgins	virgin
viciously	viciously
value-added	value-added
volts	volt
vat	vat
volley	volley
vibrate	vibrate
violators	violator
voluptuous	voluptuous
virtuoso	virtuoso
verdant	verdant
ventilator	ventilator
variances	variance
vertebrates	vertebrate
veils	veil
valor	valor
vacated	vacate
vignette	vignette
valuations	valuation
visuals	visuals
violets	violet
vertebrate	vertebrate
vaccinations	vaccination
venous	venous
vengeful	vengeful
veracity	veracity
vanquished	vanquished
vitally	vitally
vanished	vanished
vomit	vomit
viva	viva
violins	violin
vacationers	vacationer
vapors	vapor
vastness	vastness
vigilante	vigilante
validated	validate
variegated	variegated
vindictive	vindictive
vaudeville	vaudeville
viper	viper
versed	verse
valentine	valentine
vulture	vulture
vandals	vandal
verifying	verify
vale	vale
vaults	vault
vestibular	vestibular
vow	vow
vibes	vibe
vested	vest
verifiable	verifiable
vexing	vexing
vaulted	vaulted
veterinarians	veterinarian
valuables	valuables
vaccinated	vaccinate
verbatim	verbatim
vindicated	vindicate
vetoed	veto
victors	victor
visage	visage
vaunted	vaunted
vis--vis	vis--vis
videotaping	videotape
videotaped	videotape
viscous	viscous
vicarious	vicarious
venomous	venomous
vermin	vermin
viewfinder	viewfinder
volunteerism	volunteerism
verve	verve
validating	validate
vise	vise
volition	volition
vilified	vilify
visualizing	visualize
vibrated	vibrate
venting	venting
voices	voice
videotaped	videotape
vendetta	vendetta
visionaries	visionary
verified	verify
vehicular	vehicular
var	var
ventricular	ventricular
vet	vet
virtuosity	virtuosity
vehement	vehement
vouch	vouch
vulgarity	vulgarity
veering	veer
vacuuming	vacuum
veneration	veneration
vicar	vicar
veers	veer
vestige	vestige
viennese	viennese
vomited	vomit
vivacious	vivacious
vats	vat
vociferous	vociferous
vacuum	vacuum
vacate	vacate
vicariously	vicariously
valedictorian	valedictorian
void	void
vagueness	vagueness
voles	vole
vocations	vocation
vertebral	vertebral
villager	villager
voids	void
vicissitudes	vicissitude
victorians	victorian
viola	viola
vehemence	vehemence
vixen	vixen
viewership	viewership
vanishing	vanish
viscount	viscount
valise	valise
victimized	victimize
v-shaped	v-shaped
vibrancy	vibrancy
vault	vault
vetoes	veto
votive	votive
vibrato	vibrato
virginal	virginal
valence	valence
veiled	veil
vetted	vet
violator	violator
vetting	vetting
vermilion	vermilion
vane	vane
vocally	vocally
vibrates	vibrate
venereal	venereal
vigils	vigil
voiceless	voiceless
vigilantes	vigilante
vainly	vainly
vitriol	vitriol
validated	validated
viscosity	viscosity
verisimilitude	verisimilitude
voyeurism	voyeurism
vanities	vanity
voicemail	voicemail
vintages	vintage
valiantly	valiantly
vibrator	vibrator
videocassette	videocassette
vice-presidential	vice-presidential
virginians	virginian
valerian	valerian
video-game	video-game
viceroy	viceroy
vegetarianism	vegetarianism
virile	virile
vocabularies	vocabulary
validates	validate
vindicate	vindicate
vita	vita
votes	vote
vied	vie
vented	vent
vole	vole
vets	vet
victimized	victimized
virility	virility
vividness	vividness
visualized	visualize
virulence	virulence
vermouth	vermouth
vocalists	vocalist
vaccinate	vaccinate
veterinarian	veterinarian
verandah	verandah
vertebra	vertebra
voltages	voltage
vamp	vamp
vitriolic	vitriolic
vestigial	vestigial
victimhood	victimhood
voyeuristic	voyeuristic
verbalize	verbalize
ventricle	ventricle
villainous	villainous
videoconferencing	videoconferencing
vitae	vita
visitations	visitation
verbatim	verbatim
vending	vending
vasectomy	vasectomy
vaulted	vault
vociferously	vociferously
venting	vent
vacuous	vacuous
voyeur	voyeur
voice-mail	voice-mail
verging	verge
vestments	vestment
vagabond	vagabond
videogame	videogame
veiling	veil
vetoing	veto
volleys	volley
vice-versa	vice-versa
void	void
venture-capital	venture-capital
vaulting	vaulting
vanes	vane
vandalized	vandalize
varicose	varicose
vapid	vapid
vaporize	vaporize
vexed	vex
vitals	vitals
violated	violated
ventriloquist	ventriloquist
vocalizations	vocalization
virginian	virginian
vertiginous	vertiginous
vanquish	vanquish
visualized	visualize
vacuums	vacuum
videogames	videogame
vernal	vernal
vaguest	vague
varmint	varmint
vellum	vellum
venezuelans	venezuelan
veil	veil
vindicated	vindicated
vulva	vulva
vortices	vortex
vindicated	vindicate
viciousness	viciousness
velour	velour
ventilated	ventilated
vintners	vintner
verbena	verbena
valentines	valentine
vinegars	vinegar
venal	venal
vacantly	vacantly
volcanism	volcanism
vee	vee
vestibules	vestibule
voluble	voluble
viscerally	viscerally
violinists	violinist
visors	visor
virtual-reality	virtual-reality
vesting	vesting
vaulted	vault
vented	vent
vipers	viper
vacated	vacate
viscera	viscera
volumetric	volumetric
vaults	vault
vilify	vilify
veneers	veneer
verifies	verify
vexed	vexed
venerated	venerate
vermiculite	vermiculite
verbiage	verbiage
vagrants	vagrant
voyager	voyager
vaccinated	vaccinated
voraciously	voraciously
veered	veer
venerated	venerated
ventilators	ventilator
varnished	varnished
verities	verity
varietal	varietal
videographer	videographer
videophone	videophone
vagrant	vagrant
vilification	vilification
viaduct	viaduct
virtualization	virtualization
vaporized	vaporize
venetians	venetian
vancomycin	vancomycin
voluntariness	voluntariness
vacuumed	vacuum
vibrational	vibrational
vacillating	vacillate
veg	veg
vegans	vegan
vertical	vertical
verified	verified
viewscreen	viewscreen
vaccinating	vaccinate
veep	veep
vasopressin	vasopressin
vacationed	vacation
v-chip	v-chip
v-neck	v-neck
ventral	ventral
visible-light	visible-light
value-free	value-free
venusian	venusian
videodisc	videodisc
validly	validly
velvets	velvet
volitional	volitional
velveteen	velveteen
ventilated	ventilate
victimless	victimless
vexation	vexation
vids	vid
vice-chairman	vice-chairman
valance	valance
volcanos	volcano
verges	verge
vestry	vestry
voyeurs	voyeur
vaccinated	vaccinate
vassal	vassal
vegetal	vegetal
voiced	voiced
vermicelli	vermicelli
ventilate	ventilate
viewable	viewable
vintner	vintner
vocalization	vocalization
vid	vid
vacated	vacated
vetted	vet
vibrantly	vibrantly
villainy	villainy
victimize	victimize
vetoes	veto
viridian	viridian
vespers	vespers
verandas	veranda
vietnam-era	vietnam-era
voyagers	voyager
vibe	vibe
vacuumed	vacuum
vented	vented
victorian-era	victorian-era
vexing	vex
veined	veined
vindictiveness	vindictiveness
veiled	veil
valedictory	valedictory
vaporous	vaporous
valets	valet
violas	viola
victimizing	victimize
valorization	valorization
visualizations	visualization
ventriloquism	ventriloquism
vert	vert
vaporized	vaporize
vaginas	vagina
varmints	varmint
veined	vein
vocalizing	vocalize
viewings	viewing
videocassettes	videocassette
verticals	vertical
vibrators	vibrator
vocab	vocab
vomits	vomit
voice-activated	voice-activated
ventricles	ventricle
vamps	vamp
vacillation	vacillation
voiding	void
verso	verso
voyageurs	voyageur
vibratory	vibratory
vandalized	vandalize
vivacity	vivacity
ventilating	ventilating
vertex	vertex
vagrant	vagrant
valueless	valueless
value-oriented	value-oriented
vietnamese-american	vietnamese-american
variate	variate
vandalizing	vandalize
vies	vie
vindicating	vindicate
vouched	vouch
varnish	varnish
vetch	vetch
virtuality	virtuality
vanadium	vanadium
visuality	visuality
victorian-style	victorian-style
venality	venality
visual-spatial	visual-spatial
venerate	venerate
v-neck	v-neck
vitreous	vitreous
vanishingly	vanishingly
vocalize	vocalize
vagrancy	vagrancy
vetting	vet
video-on-demand	video-on-demand
videoconference	videoconference
vice-principal	vice-principal
vote-getter	vote-getter
victuals	victuals
virtuosic	virtuosic
value-laden	value-laden
vents	vent
vex	vex
vacillated	vacillate
vaster	vast
vagabonds	vagabond
vedic	vedic
vendettas	vendetta
vaporizing	vaporize
veterinary	veterinary
virologist	virologist
voter-approved	voter-approved
varnishes	varnish
viewport	viewport
vigilantism	vigilantism
vinegary	vinegary
vizier	vizier
video-based	video-based
voided	void
veiny	veiny
verts	vert
vacating	vacate
vandal	vandal
voyaging	voyage
vomited	vomit
vituperative	vituperative
voided	void
voice-recognition	voice-recognition
velodrome	velodrome
verges	verge
verged	verge
virulently	virulently
vaporizes	vaporize
visualizes	visualize
voter-registration	voter-registration
votives	votive
vesicles	vesicle
viviparous	viviparous
vanquishing	vanquish
videocamera	videocamera
verbalizing	verbalize
venturesome	venturesome
voluntarism	voluntarism
vertices	vertex
venezuelan	venezuelan
vassals	vassal
vice-presidents	vice-president
visuospatial	visuospatial
verse	verse
verdigris	verdigris
vampirism	vampirism
vigilantly	vigilantly
veils	veil
vice-chair	vice-chair
veldt	veldt
vaquero	vaquero
virtuosos	virtuoso
varnished	varnish
violist	violist
vaulter	vaulter
vasoconstriction	vasoconstriction
volatiles	volatile
vanitas	vanitas
vindicates	vindicate
vim	vim
vilifying	vilify
valedictorians	valedictorian
verticality	verticality
velcro	velcro
verge	verge
vegetated	vegetated
vasectomies	vasectomy
vaccinia	vaccinia
verbose	verbose
vaseline	vaseline
viscoelastic	viscoelastic
voting-age	voting-age
verity	verity
vacationer	vacationer
vulgarities	vulgarity
vaporized	vaporized
viticulture	viticulture
variable-speed	variable-speed
vermicomposting	vermicomposting
virology	virology
vaginally	vaginally
visages	visage
viburnum	viburnum
volumizing	volumizing
vaporization	vaporization
venial	venial
velociraptor	velociraptor
vagus	vagus
vaqueros	vaquero
valvular	valvular
vermillion	vermillion
vinaigrettes	vinaigrette
value-based	value-based
ventilatory	ventilatory
vinifera	vinifera
verily	verily
vittles	vittles
victimizer	victimizer
vampiric	vampiric
voyageur	voyageur
variegation	variegation
vituperation	vituperation
vacillate	vacillate
vine-covered	vine-covered
variably	variably
vegetable-based	vegetable-based
vexatious	vexatious
violative	violative
vitrine	vitrine
vasodilator	vasodilator
vacationed	vacation
vexed	vex
virga	virga
vision-specific	vision-specific
vestries	vestry
vainglorious	vainglorious
vote-getters	vote-getters
verbalization	verbalization
venerated	venerate
vamp	vamp
vacation	vacation
vaguer	vague
vexations	vexation
viatical	viatical
violence-prone	violence-prone
veto-proof	veto-proof
ven	ven
vice-presidency	vice-presidency
valorize	valorize
variable-rate	variable-rate
vestal	vestal
victoriously	victoriously
virtuously	virtuously
vector-borne	vector-borne
venturers	venturer
variates	variate
verbalized	verbalize
vacuity	vacuity
vouching	vouch
vote-counting	vote-counting
vodkas	vodka
vining	vining
veld	veld
vine-ripened	vine-ripened
vandalized	vandalized
vitiate	vitiate
voluptuousness	voluptuousness
volcanologists	volcanologist
valences	valence
vaporetto	vaporetto
value-neutral	value-neutral
vacuums	vacuum
vintage-inspired	vintage-inspired
vitrines	vitrine
verdure	verdure
vasodilation	vasodilation
vaporizer	vaporizer
voracity	voracity
voyage	voyage
vamping	vamp
v-chip	v-chip
voluptuously	voluptuously
viselike	viselike
value-priced	value-priced
vocationally	vocationally
vales	vale
vasculature	vasculature
versification	versification
vagal	vagal
vilest	vile
vigour	vigour
victimizers	victimizer
voltmeter	voltmeter
vasculitis	vasculitis
ventriloquists	ventriloquist
vision-related	vision-related
vacs	vac
vaudevillian	vaudevillian
verifiably	verifiably
vilified	vilified
vending-machine	vending-machine
vegetated	vegetate
viceroys	viceroy
vibraphone	vibraphone
vises	vise
viewports	viewport
vitalism	vitalism
vacuum-packed	vacuum-packed
vaunted	vaunt
valises	valise
vicepresident	vicepresident
vetted	vetted
volcanologist	volcanologist
video-editing	video-editing
viscose	viscose
voltaic	voltaic
viewscreens	viewscreen
viceregal	viceregal
vandalize	vandalize
violet-blue	violet-blue
videography	videography
virtu	virtu
viceroyalty	viceroyalty
vouchsafed	vouchsafe
vivisection	vivisection
velvet-lined	velvet-lined
victimology	victimology
variance-covariance	variance-covariance
vitiligo	vitiligo
vortexes	vortex
vitiated	vitiate
varnishing	varnish
viewfinders	viewfinder
valorized	valorize
vocational-technical	vocational-technical
viaducts	viaduct
vestment	vestment
vascularity	vascularity
vileness	vileness
verbalizations	verbalization
versicolor	versicolor
variable-star	variable-star
vasoconstrictor	vasoconstrictor
vervain	vervain
vengefulness	vengefulness
vacillates	vacillate
verbosity	verbosity
volcanically	volcanically
valorous	valorous
voting-rights	voting-rights
vireo	vireo
visualized	visualized
vegetatively	vegetatively
varnished	varnish
veneered	veneered
virginian	virginian
videodiscs	videodisc
velociraptors	velociraptor
venerates	venerate
vampy	vampy
valances	valance
vacuum-sealed	vacuum-sealed
victimizes	victimize
voicings	voicing
visored	visored
votaries	votary
vesting	vest
virologists	virologist
vote-buying	vote-buying
vicuna	vicuna
viol	viol
venoms	venom
versos	verso
voluminously	voluminously
vomits	vomit
valorizes	valorize
village-based	village-based
videographers	videographer
videocam	videocam
vouchsafed	vouchsafe
values-based	values-based
venture-backed	venture-backed
vancomycin-resistant	vancomycin-resistant
vibrio	vibrio
vice-consul	vice-consul
vengefully	vengefully
v-shape	v-shape
vintage-style	vintage-style
venders	vender
videotapes	videotape
vixens	vixen
voided	voided
veganism	veganism
videophones	videophone
volar	volar
vehicle-mounted	vehicle-mounted
vibrotactile	vibrotactile
volubly	volubly
vulgarly	vulgarly
vegas-style	vegas-style
videocameras	videocamera
venerating	venerate
vapour	vapour
varicella	varicella
verifiability	verifiability
vygotskian	vygotskian
visual-effects	visual-effects
valencian	valencian
verbal-linguistic	verbal-linguistic
vise-like	vise-like
vaulting	vault
vitamin-rich	vitamin-rich
valorizing	valorize
vilified	vilify
voyaged	voyage
vagabond	vagabond
vicarage	vicarage
vietnamese-americans	vietnamese-american
visitable	visitable
vulpine	vulpine
villainess	villainess
voluntaristic	voluntaristic
vote-rigging	vote-rigging
vichyssoise	vichyssoise
violence-related	violence-related
video-conferencing	video-conferencing
vasomotor	vasomotor
vascularized	vascularized
virilocal	virilocal
viscoelasticity	viscoelasticity
verbalized	verbalize
verifications	verification
volley	volley
vied	vie
veneered	veneer
vaudevillian	vaudevillian
vegetable	vegetable
vinyl-covered	vinyl-covered
videoconferences	videoconference
vacillated	vacillate
veritably	veritably
vanguards	vanguard
vest-pocket	vest-pocket
velvet-covered	velvet-covered
veining	veining
vouchsafe	vouchsafe
vaccine-preventable	vaccine-preventable
validations	validation
vitrification	vitrification
vanquishes	vanquish
valediction	valediction
vanilla-scented	vanilla-scented
vacillations	vacillation
vase-shaped	vase-shaped
vireos	vireo
virally	virally
verifier	verifier
vernaculars	vernacular
volutes	volute
vertical-axis	vertical-axis
vegetate	vegetate
visioning	visioning
va-va-voom	va-va-voom
vouched	vouch
vitiated	vitiate
vanload	vanload
vulgarization	vulgarization
vicars	vicar
viburnums	viburnum
valorized	valorize
viticultural	viticultural
vulvar	vulvar
voluntarist	voluntarist
victimizations	victimization
virgilian	virgilian
value-conscious	value-conscious
v-necked	v-necked
vexes	vex
venomously	venomously
video-sharing	video-sharing
vocalized	vocalize
voids	void
vivify	vivify
voicemails	voicemail
vamps	vamp
virtuosi	virtuoso
vertiginously	vertiginously
volatilization	volatilization
volute	volute
vesper	vesper
vamped	vamp
vectoring	vectore
v-chips	v-chip
vacates	vacate
video-rental	video-rental
verbalized	verbalized
vincristine	vincristine
vesicle	vesicle
virological	virological
vasodilatation	vasodilatation
vaccinees	vaccine
vainglory	vainglory
vibration-free	vibration-free
virus-free	virus-free
vogues	vogue
vindicator	vindicator
vitalize	vitalize
vitro	vitro
vacuum-tube	vacuum-tube
vasodilators	vasodilator
vacation-home	vacation-home
vocative	vocative
vees	vee
vesicular	vesicular
voicebox	voicebox
vegetable-oil	vegetable-oil
vasoconstrictors	vasoconstrictor
vacuum-cleaner	vacuum-cleaner
vacant-eyed	vacant-eyed
vibrated	vibrate
vaginitis	vaginitis
vasoactive	vasoactive
volleyballs	volleyball
vapours	vapour
ventilator-dependent	ventilator-dependent
virus-resistant	virus-resistant
valour	valour
velocimetry	velocimetry
vice-minister	vice-minister
varicocele	varicocele
volleying	volley
vilifies	vilify
vegetating	vegetate
vertebrate	vertebrate
vibraphonist	vibraphonist
voluptuary	voluptuary
vitiates	vitiate
veridical	veridical
village-level	village-level
vibration-damping	vibration-damping
viziers	vizier
vocational/technical	vocational/technical
vocalic	vocalic
virtualized	virtualized
vectorborne	vectorborne
vasovagal	vasovagal
visuo-spatial	visuo-spatial
volubility	volubility
vouches	vouch
volleyed	volley
vilely	vilely
vegetated	vegetate
vidscreen	vidscreen
voiceprints	voiceprint
velar	velar
ventromedial	ventromedial
word	lemma
the	the
even	even
men	man
least	least
police	police
quite	quite
include	include
knowledge	knowledge
set	set
doctor	doctor
build	build
surface	surface
less	less
soldiers	soldier
na	na
united	united
runs	run
farm	farm
thin	thin
views	view
essential	essential
upper	upper
earlier	early
waste	waste
caused	cause
approximately	approximately
hat	hat
bike	bike
indians	indian
devices	device
sounds	sound
draft	draft
exists	exist
married	marry
mere	mere
okay	okay
joins	join
wake	wake
fathers	father
opinions	opinion
boards	board
conversations	conversation
topics	topic
plot	plot
entitled	entitle
lip	lip
fires	fire
civilians	civilian
readily	readily
determination	determination
rage	rage
initiatives	initiative
occasions	occasion
inside	inside
tribe	tribe
manufacturer	manufacturer
citizenship	citizenship
embrace	embrace
voluntary	voluntary
driveway	driveway
occupied	occupy
flash	flash
bizarre	bizarre
boost	boost
confirmed	confirm
hurt	hurt
flu	flu
eighteen	eighteen
store	store
backed	back
continually	continually
attacked	attack
wrapped	wrap
cooperate	cooperate
trace	trace
dismissed	dismiss
helicopters	helicopter
pounding	pounding
poison	poison
worried	worry
delay	delay
develops	develop
psychiatrist	psychiatrist
saddle	saddle
stretched	stretch
continuity	continuity
precedent	precedent
prefers	prefer
pitchers	pitcher
cockpit	cockpit
delayed	delay
bombings	bombing
goodbye	goodbye
markers	marker
higher	high
canopy	canopy
triple	triple
fringe	fringe
fries	fry
respectable	respectable
glances	glance
measures	measure
scottish	scottish
ambiguity	ambiguity
onstage	onstage
automated	automated
veil	veil
freed	free
relaxed	relax
cartoons	cartoon
premium	premium
melted	melt
downward	downward
disagreed	disagree
revive	revive
inflammation	inflammation
anguish	anguish
poisoning	poisoning
fulfillment	fulfillment
lest	lest
drill	drill
pleasing	pleasing
pilgrimage	pilgrimage
pineapple	pineapple
martian	martian
brochure	brochure
frame	frame
canon	canon
insure	insure
granny	granny
powdered	powdered
fishes	fish
might	might
awakened	awaken
nightclub	nightclub
sane	sane
orientations	orientation
bloom	bloom
hydraulic	hydraulic
muster	muster
strewn	strew
lofty	lofty
coarsely	coarsely
deserted	desert
humiliating	humiliating
parchment	parchment
standoff	standoff
safest	safe
best	best
spiritually	spiritually
synonymous	synonymous
prenatal	prenatal
worthy	worthy
sweets	sweet
whereabouts	whereabouts
infusion	infusion
fencing	fencing
seventy-five	seventy-five
flickered	flicker
picturesque	picturesque
timeline	timeline
opium	opium
impartial	impartial
junior	junior
dagger	dagger
praising	praise
microbial	microbial
desolate	desolate
trusting	trusting
brethren	brother
beginner	beginner
plume	plume
algebra	algebra
nitrate	nitrate
originated	originate
revived	revive
receding	recede
heartfelt	heartfelt
hasty	hasty
discursive	discursive
diver	diver
matched	match
immortality	immortality
sift	sift
waterways	waterway
weakest	weak
chunky	chunky
cadet	cadet
editorials	editorial
tart	tart
compulsion	compulsion
summed	sum
shaker	shaker
swelled	swell
vested	vested
manned	manned
absurdity	absurdity
mainline	mainline
ascending	ascending
coexist	coexist
ecclesiastical	ecclesiastical
decoys	decoy
ratified	ratify
midwife	midwife
onlookers	onlooker
combed	comb
trotted	trot
ordination	ordination
issuers	issuer
jutting	jut
gunshots	gunshot
secretariat	secretariat
wrestler	wrestler
blight	blight
lite	lite
filth	filth
glided	glide
broiler	broiler
outback	outback
buoyant	buoyant
rappers	rapper
milestones	milestone
supplementary	supplementary
handlebar	handlebar
refresh	refresh
confectioners	confectioner
minimized	minimize
dispensing	dispense
code	code
unequivocal	unequivocal
disingenuous	disingenuous
swooped	swoop
blackberries	blackberry
freaks	freak
faceless	faceless
valiant	valiant
wholeheartedly	wholeheartedly
delegations	delegation
punches	punch
blended	blended
shrugs	shrug
original	original
sari	sari
impressionist	impressionist
revolved	revolve
vestiges	vestige
shoestring	shoestring
polished	polish
outlawed	outlaw
prohibited	prohibit
whitetail	whitetail
maniac	maniac
penicillin	penicillin
martinis	martini
eviction	eviction
rests	rest
homely	homely
grumpy	grumpy
bio	bio
contagion	contagion
nomads	nomad
sonnet	sonnet
boobs	boob
provokes	provoke
subconscious	subconscious
jigs	jig
buttered	buttered
whine	whine
likened	liken
raccoons	raccoon
self-centered	self-centered
blocker	blocker
oeuvre	oeuvre
one-stop	one-stop
thong	thong
sow	sow
anti-communist	anti-communist
calculators	calculator
whatnot	whatnot
conferring	confer
shapely	shapely
impeccably	impeccably
tic	tic
dabbed	dab
bugging	bug
screeners	screener
weighting	weighting
covariate	covariate
diminishing	diminish
emanate	emanate
eight-hour	eight-hour
straddle	straddle
verbatim	verbatim
common-sense	common-sense
cob	cob
threes	three
trashing	trash
bottling	bottling
artisanal	artisanal
acoustical	acoustical
zero-sum	zero-sum
sauntered	saunter
pissing	piss
pelagic	pelagic
ballplayers	ballplayer
salutary	salutary
insured	insured
ostracized	ostracize
pianos	piano
hustled	hustle
privatized	privatized
permafrost	permafrost
four-game	four-game
wills	will
peels	peel
outlive	outlive
excels	excel
inexcusable	inexcusable
long-sleeved	long-sleeved
orator	orator
rebelled	rebel
silos	silo
cortical	cortical
clasping	clasp
withered	withered
carcinogenic	carcinogenic
dyed	dye
steal	steal
certifying	certify
unsound	unsound
crustaceans	crustacean
cancellations	cancellation
semisweet	semisweet
debriefing	debrief
executor	executor
family-oriented	family-oriented
capitulation	capitulation
straddled	straddle
vicariously	vicariously
self-preservation	self-preservation
puffs	puff
hindering	hinder
eyed	eyed
imitators	imitator
chivalry	chivalry
evaluator	evaluator
nerdy	nerdy
analytically	analytically
invades	invade
personalized	personalize
gopher	gopher
carotene	carotene
snags	snag
hunks	hunk
racialized	racialized
psychoanalyst	psychoanalyst
third-place	third-place
liken	liken
paralyze	paralyze
deviance	deviance
honorably	honorably
paleontology	paleontology
woozy	woozy
cultivar	cultivar
trots	trot
then-president	then-president
churn	churn
degenerated	degenerate
shortwave	shortwave
haunt	haunt
self-criticism	self-criticism
unpeeled	unpeeled
malay	malay
scabs	scab
one-person	one-person
mans	man
off-balance	off-balance
handball	handball
ghoulish	ghoulish
copyrights	copyright
democratize	democratize
mutuality	mutuality
inquiring	inquire
buzzes	buzz
compressors	compressor
holdover	holdover
croissant	croissant
adorning	adorn
stages	stage
pertained	pertain
cryogenic	cryogenic
bleary-eyed	bleary-eyed
dialed	dial
wirelessly	wirelessly
beekeepers	beekeeper
persuasions	persuasion
miscommunication	miscommunication
glen	glen
commuting	commute
misreading	misreading
excluded	excluded
registries	registry
panamanians	panamanian
deflating	deflate
health-insurance	health-insurance
iceman	iceman
trumpeted	trumpet
bombs	bomb
screenwriters	screenwriter
woodpeckers	woodpecker
monotheism	monotheism
terrified	terrify
inferential	inferential
chub	chub
scouted	scout
dead-on	dead-on
inflections	inflection
terrify	terrify
south-facing	south-facing
assimilated	assimilated
itemized	itemized
dialectics	dialectic
roundabout	roundabout
sizzled	sizzle
cookout	cookout
ephemera	ephemera
mikes	mike
capital-intensive	capital-intensive
navies	navy
eardrum	eardrum
perp	perp
chinaman	chinaman
doled	dole
merited	merit
barium	barium
maturities	maturity
mind/body	mind/body
screamer	screamer
frigging	frigging
aggregated	aggregated
globules	globule
cubist	cubist
febrile	febrile
persimmons	persimmon
junket	junket
cargoes	cargo
discontents	discontent
below-average	below-average
charlatan	charlatan
bungled	bungled
mothballs	mothball
lustful	lustful
ill-suited	ill-suited
namibian	namibian
nonconference	nonconference
jiffy	jiffy
superficiality	superficiality
coexisted	coexist
pocked	pock
imago	imago
four-speed	four-speed
potentiality	potentiality
cycled	cycle
venal	venal
boatload	boatload
centurion	centurion
snowmen	snowman
scowls	scowl
clout	clout
life-or-death	life-or-death
reestablished	reestablish
subsidence	subsidence
snowmobiling	snowmobiling
gynecologists	gynecologist
steadies	steady
designed	designed
triads	triad
twenty-second	twenty-second
raincoats	raincoat
phase	phase
standing-room-only	standing-room-only
inversions	inversion
precut	precut
glorified	glorify
shimmied	shimmy
aggregations	aggregation
electrocardiogram	electrocardiogram
slurred	slurred
moray	moray
japanese-style	japanese-style
jingled	jingle
nanomachines	nanomachine
inboard	inboard
beheaded	behead
notched	notch
end-use	end-use
vagrant	vagrant
house-to-house	house-to-house
neoplasms	neoplasm
comportment	comportment
sympathizes	sympathize
nigerian	nigerian
nabbed	nab
mappings	mapping
hypothesizes	hypothesize
postliberal	postliberal
basso	basso
life-affirming	life-affirming
asylums	asylum
abeyance	abeyance
exchange-rate	exchange-rate
interdict	interdict
salable	salable
pyrotechnic	pyrotechnic
two-bit	two-bit
poststructuralism	poststructuralism
systemically	systemically
disconcertingly	disconcertingly
visible-light	visible-light
bombardments	bombardment
maglev	maglev
balkanization	balkanization
ejecting	eject
brown-haired	brown-haired
now-familiar	now-familiar
disassembly	disassembly
squeaks	squeak
councilor	councilor
misdirected	misdirected
mastoid	mastoid
scrunch	scrunch
nativists	nativist
bitter	bitter
trawl	trawl
father-daughter	father-daughter
archrival	archrival
autoworkers	autoworker
jocular	jocular
oracular	oracular
starker	stark
beanstalk	beanstalk
proffered	proffer
nonfarm	nonfarm
lower-middle	lower-middle
e-business	e-business
walled	wall
custards	custard
shod	shoe
scarification	scarification
billow	billow
groomers	groomer
mouthed	mouth
soy-based	soy-based
bloomed	bloom
spatulas	spatula
sight-singing	sight-singing
jot	jot
scalability	scalability
temptress	temptress
indepth	indepth
potholed	potholed
recouped	recoup
pocked	pock
haystacks	haystack
fasciitis	fasciitis
waterless	waterless
four-factor	four-factor
extricating	extricate
morphologically	morphologically
chart-topping	chart-topping
capitalized	capitalized
savaged	savage
impudence	impudence
scrip	scrip
hollow-eyed	hollow-eyed
defame	defame
intensional	intensional
washbasin	washbasin
boatyard	boatyard
tipoff	tipoff
marketeers	marketeer
pointlessly	pointlessly
nuclear-free	nuclear-free
nitride	nitride
well-studied	well-studied
familiars	familiar
undone	undone
million-member	million-member
gook	gook
cozying	cozy
pocked	pocked
precocity	precocity
copped	cop
businesswomen	businesswoman
natatorium	natatorium
cases	case
forget-me-nots	forget-me-not
item-total	item-total
vacillated	vacillate
waked	wake
capon	capon
impinges	impinge
data-collection	data-collection
ethnolinguistic	ethnolinguistic
cluck	cluck
pinochle	pinochle
dispersed	disperse
incandescence	incandescence
co-payment	co-payment
hamming	ham
sodomized	sodomize
delft	delft
vomited	vomit
dozes	doze
velodrome	velodrome
presages	presage
cosponsors	cosponsor
sprayers	sprayer
spiraled	spiral
sub-zero	sub-zero
arteriosclerosis	arteriosclerosis
seatings	seating
overrated	overrate
all-round	all-round
illiquid	illiquid
seven-story	seven-story
high-concept	high-concept
expensing	expense
astrolabe	astrolabe
misspelled	misspelled
yogurts	yogurt
decongestant	decongestant
fleshing	flesh
healed	healed
animistic	animistic
retells	retell
carry-out	carry-out
consenting	consent
sumptuously	sumptuously
scarily	scarily
filberts	filbert
sigmoidoscopy	sigmoidoscopy
nestled	nestled
footed	footed
cheerio	cheerio
boded	bode
english-style	english-style
threesomes	threesome
clientelistic	clientelistic
telegraphs	telegraph
agitprop	agitprop
boy-girl	boy-girl
goldenseal	goldenseal
repatriating	repatriate
co-chairwoman	co-chairwoman
lodgers	lodger
unshakeable	unshakeable
inaugurations	inauguration
multilayer	multilayer
innervation	innervation
upends	upend
antiballistic	antiballistic
clucks	cluck
etruscans	etruscan
mislaid	mislay
earthward	earthward
categorized	categorized
autoimmunity	autoimmunity
thumped	thump
cost/benefit	cost/benefit
silkworm	silkworm
tutee	tutee
shipwrecked	shipwreck
half-timbered	half-timbered
trans-alaska	trans-alaska
angiosperm	angiosperm
indoctrinating	indoctrinate
eight-team	eight-team
absorbable	absorbable
pec	pec
skullduggery	skullduggery
perplexities	perplexity
nonperforming	nonperforming
accelerant	accelerant
hashed	hash
dazedly	dazedly
creaming	cream
stoners	stoner
arsenate	arsenate
singeing	singe
off-ramp	off-ramp
hub-and-spoke	hub-and-spoke
shootdown	shootdown
payee	payee
auctions	auction
uploads	upload
two-by-two	two-by-two
selectmen	selectman
middle-sized	middle-sized
major-league	major-league
fibs	fib
preempts	preempt
solar-type	solar-type
fair-sized	fair-sized
stupefaction	stupefaction
inessential	inessential
contraries	contrary
deliverables	deliverable
slosh	slosh
ethnomusicologist	ethnomusicologist
highest-ranked	highest-ranked
female-dominated	female-dominated
shade-grown	shade-grown
affronted	affront
jangle	jangle
heartwood	heartwood
belligerency	belligerency
nonmagnetic	nonmagnetic
tenderest	tender
decayed	decay
yowling	yowl
gummed	gummed
sino-japanese	sino-japanese
bobble	bobble
offseasons	offseason
cable-television	cable-television
eyestrain	eyestrain
organised	organised
burnet	burnet
variates	variate
repulsed	repulsed
obfuscating	obfuscate
test-fired	test-fired
hickory-smoked	hickory-smoked
surfactants	surfactant
concessioners	concessioner
half-listening	half-listening
eight-lane	eight-lane
cornflowers	cornflower
prostates	prostate
ephemerality	ephemerality
biospherians	biospherian
white-walled	white-walled
sleekness	sleekness
matriculated	matriculate
human-animal	human-animal
self-test	self-test
unibody	unibody
snowballing	snowballing
five-room	five-room
doo-wop	doo-wop
chainstay	chainstay
angstrom	angstrom
fibrotic	fibrotic
unspecific	unspecific
fizzles	fizzle
handedly	handedly
barbiturate	barbiturate
final-status	final-status
erosional	erosional
overclocking	overclocking
propound	propound
fetchingly	fetchingly
best-of-five	best-of-five
first-level	first-level
swivelled	swivel
portcullis	portcullis
reed-thin	reed-thin
condescended	condescend
ingrate	ingrate
non-refundable	non-refundable
high-occupancy	high-occupancy
microsurgical	microsurgical
bride-price	bride-price
dirtied	dirty
five-cent	five-cent
swept-back	swept-back
essayed	essay
rebuffs	rebuff
piste	piste
barbadian	barbadian
juggernauts	juggernaut
broaches	broach
ubiquitously	ubiquitously
noncancerous	noncancerous
phlebitis	phlebitis
goslings	gosling
quant	quant
sashays	sashay
stupendously	stupendously
zings	zing
overexertion	overexertion
artifices	artifice
lawn-care	lawn-care
pre-state	pre-state
case-based	case-based
spot-on	spot-on
gabbling	gabble
cohost	cohost
high-walled	high-walled
conventionalized	conventionalized
undecidable	undecidable
fairgoers	fairgoer
dvd-rom	dvd-rom
deduces	deduce
nuttier	nutty
on-location	on-location
babushkas	babushka
zipped	zipped
idylls	idyll
open-endedness	open-endedness
dolphin-safe	dolphin-safe
toughed	tough
outmaneuvering	outmaneuver
tablemates	tablemate
self-same	self-same
earplug	earplug
blipped	blip
community-development	community-development
once-daily	once-daily
malawian	malawian
phronesis	phronesis
recalculated	recalculate
squishes	squish
unkept	unkept
flirts	flirt
doorpost	doorpost
elastics	elastic
print-outs	print-out
cowled	cowled
modernities	modernity
teflon-coated	teflon-coated
poignance	poignance
vomits	vomit
average-looking	average-looking
overstated	overstated
hip-hoppers	hip-hopper
lawn-mower	lawn-mower
young-old	young-old
sex-toy	sex-toy
consilium	consilium
commandeers	commandeer
modern-looking	modern-looking
palpating	palpate
misplacement	misplacement
schemed	scheme
antiracism	antiracism
briers	brier
fraudster	fraudster
minitower	minitower
mother-adolescent	mother-adolescent
firstclass	firstclass
suprisingly	suprisingly
writer/producer	writer/producer
opposite-field	opposite-field
flash-frozen	flash-frozen
extra-terrestrial	extra-terrestrial
anti-nausea	anti-nausea
cha-ching	cha-ching
post-polio	post-polio
self-relevant	self-relevant
comfortable-looking	comfortable-looking
low-yielding	low-yielding
highest-risk	highest-risk
demur	demur
undesignated	undesignated
detainment	detainment
tumescent	tumescent
assessable	assessable
instantiates	instantiate
squeezebox	squeezebox
sisterhoods	sisterhood
forwards	forward
clothed	clothe
spiritedly	spiritedly
nine-man	nine-man
larders	larder
anti-skid	anti-skid
aldehydes	aldehyde
turbos	turbo
pound-feet	pound-feet
mouser	mouser
underlayment	underlayment
periodized	periodized
number-crunching	number-crunching
twoyear	twoyear
thirst-quenching	thirst-quenching
brightly-lit	brightly-lit
batch	batch
toddies	toddy
six-cd	six-cd
post-freudian	post-freudian
gynaecology	gynaecology
bakeware	bakeware
acid-base	acid-base
harpooner	harpooner
frat-house	frat-house
prizefight	prizefight
fawn-colored	fawn-colored
transmuted	transmute
grandmom	grandmom
spit-roasted	spit-roasted
freebasing	freebasing
perturbing	perturbing
silk-chiffon	silk-chiffon
neuropsychiatry	neuropsychiatry
microlending	microlending
silversides	silversides
capriccio	capriccio
near-flawless	near-flawless
blousy	blousy
codpiece	codpiece
bussed	buss
non-cancerous	non-cancerous
weepers	weeper
dehumidifiers	dehumidifier
white-throated	white-throated
kinking	kink
endotoxins	endotoxin
replicants	replicant
pleura	pleura
mill-levy	mill-levy
swamped	swamped
wielders	wielder
scantily-clad	scantily-clad
flea-bitten	flea-bitten
routs	rout
plusses	pluss
documentations	documentation
touchbacks	touchback
white-meat	white-meat
wheel-chair	wheel-chair
topsail	topsail
geoscientists	geoscientist
rarebit	rarebit
freeplay	freeplay
accedes	accede
drive-bys	drive-bys
radiologically	radiologically
criers	crier
metal-framed	metal-framed
axes	ax
bogey-free	bogey-free
revolutionizes	revolutionize
economic-stimulus	economic-stimulus
pizzicato	pizzicato
focally	focally
high-earning	high-earning
neotraditional	neotraditional
doublings	doubling
ya-yas	ya-ya
subversiveness	subversiveness
unlatching	unlatch
discount-store	discount-store
offed	off
lumberman	lumberman
half-inch-thick	half-inch-thick
unharnessed	unharnessed
quick-and-easy	quick-and-easy
door-way	door-way
cocoa-colored	cocoa-colored
narrativization	narrativization
overtopped	overtop
lassies	lassie
fluconazole	fluconazole
nonabusive	nonabusive
polymyositis	polymyositis
shirked	shirk
minor-leaguer	minor-leaguer
inflects	inflect
cherry-picked	cherry-picked
spectres	spectre
neaten	neaten
eld	eld
herstory	herstory
squalled	squall
appropriative	appropriative
time-and-a-half	time-and-a-half
shoehorn	shoehorn
kid-free	kid-free
infectiousness	infectiousness
homogenate	homogenate
hyphenation	hyphenation
silvery-blue	silvery-blue
fantasias	fantasia
long-festering	long-festering
deactivating	deactivate
scampered	scamper
narrow-shouldered	narrow-shouldered
undisputable	undisputable
pound-foolish	pound-foolish
yet-to-be-named	yet-to-be-named
coolheaded	coolheaded
yearend	yearend
emission-control	emission-control
non-normal	non-normal
biryani	biryani
embossing	embossing
independent-samples	independent-samples
septicaemia	septicaemia
slum-dwellers	slum-dwellers
mistily	mistily
ill-bred	ill-bred
spackle	spackle
reappointed	reappoint
floriferous	floriferous
oligotrophic	oligotrophic
velar	velar